ABACA  -->  TAREI, COLUN, SAPAM, ABDIC, ABACA, 5
ABACE  -->  TAREI, SALCE, POUND, ABACE, 4
ABALE  -->  TAREI, SALCE, PLUMB, BANJO, ADAOG, ABALE, 6
ABATA  -->  TAREI, SOCUL, TAMAN, BATAV, GAZAT, ADIAT, ABATA, 7
ABATE  -->  TAREI, SALTA, UBACE, ABACA, ABATE, 5
ABATI  -->  TAREI, CATAU, PANAS, BATAL, ABTIE, ABACA, ABATI, 7
ABATU  -->  TAREI, SOCUL, MANAT, BATAJ, BAZAT, BUBAT, ADIAT, ABATU, 8
ABAUA  -->  TAREI, COLUN, SFADA, ABACA, ABAUA, 5
ABCES  -->  TAREI, CALUS, ABCES, 3
ABDIC  -->  TAREI, SALCI, CAUNI, CAPII, CADII, ABACA, ABDIC, 7
ABILA  -->  TAREI, SALCI, MULII, PANII, BOLII, BADIA, ALBEA, ABACA, ABILA, 9
ABILE  -->  TAREI, MASLE, ABNEG, ABILE, 4
ABILI  -->  TAREI, SACAL, ALBUM, ABILA, ABILI, 5
ABJUR  -->  TAREI, MORUA, LACAS, AGAPA, ABACA, ABJUR, 6
ABNEG  -->  TAREI, CALUS, DANGA, ABACA, ABNEG, 5
ABOLI  -->  TAREI, SACAL, ALBUM, ABILA, ABILE, ABILI, ABOLI, 7
ABONA  -->  TAREI, COLUN, SAMAN, BOGZA, ABONA, 5
ABRAC  -->  TAREI, CUMAS, BALAC, ABRAC, 4
ABRAS  -->  TAREI, CUMAS, ADOPT, ABRAS, 4
ABROG  -->  TAREI, CUMAS, BOGZA, ABROG, 4
ABTIE  -->  TAREI, LATEA, CAVEI, SABIA, ABACA, ABTIE, 6
ABTII  -->  TAREI, CATAU, DOPAM, HABAN, ABDIC, ABTII, 6
ABTIN  -->  TAREI, SANTI, TANAI, TANTI, TANAT, TANCA, TANGA, TAINA, TANAU, TONII, TANJI, TABLA, ABACA, ABTIN, 14
ABTIU  -->  TAREI, SANTI, CAUTI, TUITI, TAIAI, MATAI, BAGAI, ABAUA, ABTIU, 9
ABURC  -->  TAREI, MORUA, SULAC, ABNEG, ABURC, 5
ABURI  -->  TAREI, CARUB, ABRAC, ABURI, 4
ABUZA  -->  TAREI, COLUN, SAPAM, GAZDA, ABUZA, 5
ACAJU  -->  TAREI, COLUN, CUSMA, CAPAU, BACAI, AUZUL, ACAJU, 7
ACANA  -->  TAREI, COLUN, BANCA, ADINS, ACANA, 5
ACANI  -->  TAREI, SACAL, CAPAU, CANIM, CANID, CANII, CAINA, ABILA, ACANI, 9
ACANT  -->  TAREI, SOCUL, CAPAN, BANCA, BANTA, CABAZ, CABLA, CABRA, CACAO, CADEA, CADRA, CAFAS, CAFEA, CAHLA, CAIAC, CAIAI, CAIAM, CAIAU, CAINA, ACANT, 20
ACARE  -->  TAREI, MARSE, BOARD, CRUPA, ABACA, ACARE, 6
ACARI  -->  TAREI, CARUB, CARAS, CARAM, CAPAN, CARCA, CAICE, CARAB, CARAI, CRAIA, ARDIL, ABACA, ABACE, ABURC, ACARI, 15
ACASA  -->  TAREI, COLUN, SAPAM, SVABA, AFIDA, ACASA, 6
ACATA  -->  TAREI, SOCUL, CAPAN, MATCA, ABATA, ACATA, 6
ACATE  -->  TAREI, SALTA, UBACE, ABACA, ACATE, 5
ACATI  -->  TAREI, CATAU, CANAL, CAIAM, CAIAC, CAIAI, CAIAU, CAITA, ADINS, ACATI, 10
ACCED  -->  TAREI, CALUS, CACOM, ZAIFA, AGAPA, ACCED, 6
ACCES  -->  TAREI, CALUS, ABCES, ACCES, 4
ACCIZ  -->  TAREI, SALCI, CAUNI, CAPII, CADII, MAZGI, ABDIC, ABCES, ACCIZ, 9
ACEEA  -->  TAREI, CALUS, CACOM, FACEA, NACAZ, CHEAG, ACEEA, 7
ACEIA  -->  TAREI, MASLE, DANCI, CAPIE, ACCED, ACEIA, 6
ACELA  -->  TAREI, SALCE, CLAPE, CAULE, CALFA, ABACA, ACELA, 7
ACELE  -->  TAREI, SALCE, CLAMP, FOACI, CABLU, ABACA, ACELE, 7
ACERA  -->  TAREI, MARSE, CARDA, CAREU, AEREZ, ABCES, ABNEG, ABRAC, ABRAS, ABROG, ABURC, ACERA, 12
ACERB  -->  TAREI, MARSE, CARDA, CEREA, CAPRA, ABACA, ACERB, 7
ACERE  -->  TAREI, MARSE, BOARD, PLACU, ABACA, ABACE, ABALE, ABATA, ABATE, ABATI, ABATU, ABAUA, ACAJU, ACANA, ACANI, ACANT, ACARE, ACERE, 18
ACERI  -->  TAREI, ACREA, ABCES, ABNEG, ABRAC, ABRAS, ABROG, ABURC, ACERI, 9
ACEST  -->  TAREI, SALTA, SECTA, CETET, ABCES, ABNEG, ACAJU, ACEST, 8
ACHII  -->  TAREI, SACAL, CAPAU, CANIM, IZVOD, BAGAJ, ABACA, ACHII, 8
ACHIT  -->  TAREI, SANTI, CAUTI, CATII, CATOD, ALBET, ACHIT, 7
ACHIU  -->  TAREI, SALCI, CAUNI, CAPAI, CAIZI, CHIDA, ABATI, ACHIU, 8
ACIDA  -->  TAREI, SALCI, CAUNI, CAPII, CADII, DAICI, ALOCA, ABACA, ABACE, ACAJU, ACIDA, 11
ACIDE  -->  TAREI, MASLE, CAIND, ACIDE, 4
ACILA  -->  TAREI, SALCI, CALCI, CALMI, CAPII, CALII, CLICI, ALICA, ACILA, 9
ACILI  -->  TAREI, SACAL, CALIM, CALCA, CALCE, CALCI, CAZON, CAICE, ABACA, ABACE, ABALE, ACILI, 12
ACINE  -->  TAREI, MASLE, CAIND, ABACA, ACINE, 5
ACIRA  -->  TAREI, CURII, CARAI, CASII, CARII, CAIRI, ACHII, ABACA, ACIRA, 9
ACIRE  -->  TAREI, CARIE, ABDIC, ABILA, ACIRE, 5
ACIRI  -->  TAREI, CARUB, CARAS, CARAM, CAPAN, CARCA, CAICE, ABACA, ABACE, ABURC, ACIRI, 11
ACIUA  -->  TAREI, SALCI, CAUNI, CAPAI, CAIZI, BUDAI, CALCA, ACLAM, ACIUA, 9
ACIUI  -->  TAREI, SACAL, CAPAU, CAZAN, FUCUS, ACHII, ACIUI, 7
ACIZI  -->  TAREI, SACAL, CAPAU, CANIM, CABAZ, CAIAC, ABACA, ACIZI, 8
ACLAM  -->  TAREI, COLUN, CAMPA, ABRAC, ACLAM, 5
ACNEE  -->  TAREI, CALUS, CACOM, FACEA, NACAZ, ABACA, ACNEE, 7
ACOLO  -->  TAREI, COLUN, COPAL, BOCAL, COLAM, SOLVA, CODAJ, COLEA, COLIA, COLNA, COAFA, CAHLA, ABACA, ACOLO, 14
ACONT  -->  TAREI, SOCUL, COTAM, CATAT, CAIND, ACONT, 6
ACORD  -->  TAREI, MORUA, BORNA, SOLDA, DOARA, ABACA, ACORD, 7
ACQUA  -->  TAREI, COLUN, PADOC, ABACA, ACQUA, 5
ACREA  -->  TAREI, CAZMA, AEDUL, ACREA, 4
ACREI  -->  TAREI, MACHO, ABACA, ACREI, 4
ACRIA  -->  TAREI, MUCII, BALSA, ABACA, ACRIA, 5
ACRIE  -->  TAREI, CAPEI, ABACE, ACRIE, 4
ACRII  -->  TAREI, CUBAM, COJII, ABACA, ACRII, 5
ACRIM  -->  TAREI, MUCII, ACRIM, 3
ACRIS  -->  TAREI, MUCII, BALSA, ABACA, ACRIS, 5
ACRIT  -->  TAREI, TACIT, ACRIT, 3
ACRIU  -->  TAREI, MUCII, ABACA, ACRIU, 4
ACRUL  -->  TAREI, CUMAS, CUBAU, CANAL, ABACA, ACRUL, 6
ACRUT  -->  TAREI, TUSCA, CABLA, CABRA, CADEA, CADET, ABAUA, ACRUT, 8
ACTIV  -->  TAREI, SANTI, CAUTI, CATII, ABACA, ACTIV, 6
ACTOR  -->  TAREI, CURAT, CROAT, ABRAC, ACTOR, 5
ACTUL  -->  TAREI, SOCUL, ABCES, ACTUL, 4
ACUMA  -->  TAREI, COLUN, CUSMA, ACUMA, 4
ACUSA  -->  TAREI, COLUN, CUSMA, SPUSA, ABACA, ACUSA, 6
ACUSI  -->  TAREI, SACAL, CAIAU, ABAUA, ACUSI, 5
ACUTA  -->  TAREI, SOCUL, CATAT, CUTAT, CATAM, BATAT, TAPAT, TANAT, DATAT, TUCAT, CAZAT, FATAT, CATAU, CUCUT, CUTIT, GATAT, MATAT, PATAT, RATAT, TACTA, ABACA, ACUTA, 22
ACUTE  -->  TAREI, SALTA, UBACE, ABACA, ACUTE, 5
ACUTI  -->  TAREI, CATAU, AUTUL, ACUTI, 4
ACUZA  -->  TAREI, COLUN, CUSMA, ADUCA, ABACA, ABACE, ABUZA, ACUZA, 8
ACUZE  -->  TAREI, SALCE, MANCO, APUCA, ABACA, ABACE, ABDIC, ACUZE, 8
ACUZI  -->  TAREI, SACAL, CAPAU, CAZAN, ABCES, ACUZI, 6
ADANC  -->  TAREI, COLUN, BANCA, CAPSA, CANEA, CANTA, CAUZA, ABRAC, ADANC, 9
ADAOG  -->  TAREI, COLUN, SAPAM, BOARD, ABACA, ADAOG, 6
ADAOS  -->  TAREI, COLUN, SAPAM, DOBAS, ADAOS, 5
ADAPA  -->  TAREI, COLUN, SAPAM, DOPAJ, ADAPA, 5
ADAPE  -->  TAREI, SALCE, POUND, ADAPE, 4
ADAPI  -->  TAREI, SACAL, MANAU, ZAPAJ, HAPAI, VAIAG, DAIAC, ABDIC, ADAPI, 9
ADAST  -->  TAREI, SOCUL, TAMPA, TAFNA, SVABA, ABACA, ABATA, ABAUA, ABDIC, ADAST, 10
ADAUG  -->  TAREI, COLUN, SFADA, ADAUG, 4
ADAUS  -->  TAREI, COLUN, SFADA, ADAUS, 4
ADECA  -->  TAREI, SALCE, APUNE, ABACA, ADECA, 5
ADEPT  -->  TAREI, SALTA, TANCE, TAMPE, ATACA, ADEPT, 6
ADERA  -->  TAREI, MARSE, CARDA, RADOU, DEFEL, AEREZ, ABCES, ABDIC, ABNEG, ABURC, ADERA, 11
ADERE  -->  TAREI, MARSE, BOARD, ABACA, ADERE, 5
ADERI  -->  TAREI, ACREA, PEDES, ABCES, ABDIC, ABNEG, ABURC, ADERI, 8
ADESE  -->  TAREI, SALCE, SOUND, ABACA, ADESE, 5
ADIAI  -->  TAREI, SACAL, PAION, ALBUM, ADIAI, 5
ADIAM  -->  TAREI, SALCI, MANAU, BAZOI, PADII, ABDIC, ABILA, ADIAM, 8
ADIAT  -->  TAREI, SANTI, CAUTI, LAPAI, TIMFI, TIVGI, TATOI, TAIAT, ABACA, ADIAT, 10
ADIAU  -->  TAREI, SALCI, MANAU, BIVOL, HAPAX, ABDIC, ADIAU, 7
ADICA  -->  TAREI, SALCI, MUNDI, ABOLI, ADICA, 5
ADIEM  -->  TAREI, MALOS, MAIND, ADIEM, 4
ADINS  -->  TAREI, SALCI, SUPAI, SANII, NANII, SANIA, SISAI, BISAI, FANII, MANII, DOGII, ADINS, 12
ADMIR  -->  TAREI, CURII, SARMA, ZARNA, MAMBA, ACIDA, ADMIR, 7
ADMIS  -->  TAREI, SALCI, SUPAI, SANII, SAMBA, ABACA, ADMIS, 7
ADMIT  -->  TAREI, SANTI, CAUTI, LAPAI, TAMAI, ACEIA, ADMIT, 7
ADNAT  -->  TAREI, SOCUL, TAMAN, BANAT, HAVEZ, AFGAN, ADNAT, 7
ADOPT  -->  TAREI, SOCUL, NOPAM, POPAZ, DOAPA, ADOPT, 6
ADORA  -->  TAREI, MORUA, BOARD, ABACA, ADORA, 5
ADORE  -->  TAREI, MARSE, BOARD, ABACA, ADORE, 5
ADORI  -->  TAREI, CARUB, GAMAN, PROIS, ABDIC, ADORI, 6
ADORM  -->  TAREI, MORUA, MORNA, MORSA, MORVA, MARDA, ACLAM, ADORM, 8
ADUCA  -->  TAREI, COLUN, CUSMA, ADUCA, 4
ADUCE  -->  TAREI, SALCE, POUND, ADUCE, 4
ADUCI  -->  TAREI, SACAL, CAPAU, CAZAN, FUCUS, CUCUI, CUCUL, CUCUT, DUCAI, ADUCI, 10
ADUCT  -->  TAREI, SOCUL, CATAT, TACAI, TACAM, TACAN, CODAJ, ABACA, ADUCT, 9
ADULA  -->  TAREI, COLUN, SALAM, GAZDA, DAULA, ADULA, 6
ADULT  -->  TAREI, SOCUL, PATUT, AFLAM, ABALE, ADULT, 6
ADUNA  -->  TAREI, COLUN, FANDA, ABNEG, ADUNA, 5
ADUNE  -->  TAREI, SALCE, POUND, ABACA, ADUNE, 5
ADUNI  -->  TAREI, SACAL, MANAU, BAIND, ADUNI, 5
ADUSA  -->  TAREI, COLUN, SAPAM, DUBAS, BUJDA, ACASA, ADUSA, 7
ADUSE  -->  TAREI, SALCE, SOUND, ACASA, ADUSE, 5
ADUSI  -->  TAREI, SACAL, SAPAU, SAMAN, ADAUG, ADUSI, 6
ADVON  -->  TAREI, COLUN, PASAM, AFGAN, ADVON, 5
AEDUL  -->  TAREI, SALCE, POLUA, ABDIC, AEDUL, 5
AEQUO  -->  TAREI, SALCE, MUNDA, AGAVA, ABAUA, AEQUO, 6
AERAI  -->  TAREI, MACHO, BUDEZ, PEGAS, AERAI, 5
AERAJ  -->  TAREI, MACES, BADEA, PAVEZ, GAUNA, HALAJ, AERAJ, 7
AERAM  -->  TAREI, MACES, MADEA, MALEA, MANEA, BAGEA, MAREA, FACEM, ACHII, AERAM, 10
AERAT  -->  TAREI, TAFTA, TACTA, TASTA, TANTA, TAMPE, TAFTE, TANTE, TARTA, TARTE, ALBET, AERAT, 12
AERAU  -->  TAREI, MACES, BADEA, PAVEZ, GAUNA, AEDUL, AERAU, 7
AEREZ  -->  TAREI, CAZMA, BENGA, ABACA, AEREZ, 5
AEROB  -->  TAREI, MACES, BADEA, BANJO, ABACA, AEROB, 6
AEROS  -->  TAREI, MACES, ABCES, AEROS, 4
AERUL  -->  TAREI, MACES, BADEA, PAVEZ, GAUNA, AEDUL, AERUL, 7
AEZII  -->  TAREI, MASLU, VADAN, GOPAC, BARIZ, AEZII, 6
AFANA  -->  TAREI, COLUN, MANSA, VANDA, HAZNA, ABACA, AFANA, 7
AFARA  -->  TAREI, MORUA, SCARP, AFIXE, AFARA, 5
AFECT  -->  TAREI, SALTA, TANCE, TOABE, ABACA, ABACE, ABALE, ABATA, ABATE, ABATI, ABATU, ABAUA, ABILE, ABTIE, ACAJU, ACANA, ACANI, ACANT, AFECT, 19
AFGAN  -->  TAREI, COLUN, BAGAM, ABUZA, AFGAN, 5
AFIDA  -->  TAREI, SALCI, MANAU, ZODII, VIPII, FAGII, ABACA, AFIDA, 8
AFIDE  -->  TAREI, MASLE, CAIND, GAFEZ, AFIDE, 5
AFIFA  -->  TAREI, SALCI, MANAU, ZODII, PAGAI, JABIA, AFANA, AFIFA, 8
AFIFE  -->  TAREI, MASLE, CAIND, AXEZE, AFIFE, 5
AFIFI  -->  TAREI, SACAL, MANAU, ZAPAJ, GHIOB, ABDIC, AFIFI, 7
AFINA  -->  TAREI, SALCI, MANAU, PODII, VAGII, ZAIFI, ABACA, AFINA, 8
AFINE  -->  TAREI, MASLE, CAIND, AFIPT, AFINE, 5
AFINI  -->  TAREI, SACAL, MANAU, PONIV, DANIA, FANII, ABILA, AFINI, 8
AFION  -->  TAREI, SALCI, MANAU, PODII, NAIVA, FIXAJ, AFION, 7
AFIPT  -->  TAREI, SANTI, CAUTI, LAPAI, POPII, TAPII, TAIAI, ABATI, ABILI, ABOLI, ABTII, ABURI, ACANI, ACANT, AFIPT, 15
AFIRM  -->  TAREI, CURII, MORII, MARAI, MARIM, RAGAZ, ABRAS, AFIRM, 8
AFISA  -->  TAREI, SALCI, SUPAI, SANII, MASAI, SABAI, SASAI, FASAI, DOSII, ADIAI, AFISA, 11
AFISE  -->  TAREI, MASLE, SAFIC, ABACA, AFISE, 5
AFIXE  -->  TAREI, MASLE, CAIND, AXEZE, AFIXE, 5
AFLAI  -->  TAREI, SACAL, LIMFO, ACLAM, AFLAI, 5
AFLAM  -->  TAREI, COLUN, VISAM, ABACA, AFLAM, 5
AFLAT  -->  TAREI, SOCUL, TALAN, MAZUT, ACHII, AFLAT, 6
AFLAU  -->  TAREI, COLUN, SUPAM, FAVOR, ABACA, AFLAU, 6
AFLUI  -->  TAREI, SACAL, ALBUM, ABDIC, AFLUI, 5
AFLUX  -->  TAREI, COLUN, PASOL, VAGAL, HAMAL, ACRUL, ACTUL, AEDUL, AERUL, AFANA, AFLUX, 11
AFONA  -->  TAREI, COLUN, SAMAN, BOGZA, ABACA, AFONA, 6
AFONE  -->  TAREI, SALCE, POUND, ABNEG, AFONE, 5
AFONI  -->  TAREI, SACAL, MANAU, PONIV, AFUND, AFONI, 6
AFTEI  -->  TAREI, FATAL, ABACA, AFTEI, 4
AFTOR  -->  TAREI, CURAT, SARAT, FORAT, ABOLI, AFTOR, 6
AFTOS  -->  TAREI, SOCUL, PATAT, BATOG, CAVAF, ABACA, AFTOS, 7
AFUMA  -->  TAREI, COLUN, SAPAM, BIFAM, ABATU, AFUMA, 6
AFUME  -->  TAREI, SALCE, POUND, ABUZA, AFUME, 5
AFUMI  -->  TAREI, SACAL, MANAU, CAVAF, ABACA, AFUMI, 6
AFUND  -->  TAREI, COLUN, FANDA, ABACA, AFUND, 5
AFURC  -->  TAREI, MORUA, SULAC, ABNEG, AFURC, 5
AGALE  -->  TAREI, SALCE, PLUMB, GOANA, AEDUL, AGALE, 6
AGAPA  -->  TAREI, COLUN, SAPAM, DOPAJ, ABACA, AGAPA, 6
AGAPE  -->  TAREI, SALCE, POUND, AGAVA, AGAPE, 5
AGASA  -->  TAREI, COLUN, SAPAM, GAFEZ, ABACA, AGASA, 6
AGATA  -->  TAREI, SOCUL, TAMAN, BATAV, PAFUG, AZTEC, AGATA, 7
AGATE  -->  TAREI, SALTA, UBACE, TOPIM, ATING, AGATE, 6
AGATI  -->  TAREI, CATAU, PANAS, BATAL, VATAM, TOIAG, GAIAC, GAIAL, TAIAI, TAIAM, TAIAT, TAIAU, BAGAI, BAGAJ, BAGAM, BAGAT, BAGAU, BATAI, BATAJ, BATAN, BATAR, BATAT, BATAV, CATAI, CATAM, CATAR, CATAT, DAGII, DATAI, DATAM, DATAT, DATAU, FAGAS, FAGII, FATAI, FATAL, FATAT, FATAU, GAFAI, GAFAM, GAFAT, GAFAU, GAGAI, GAGAT, GAGIC, GAGII, GAGIU, GAJAI, GAMAN, GANAS, GARAI, GARAJ, GARAM, GARAT, GARAU, GATAI, BAIAI, BAIAM, BAIAN, BAIAS, BAIAT, BAIAU, BIGII, CAIAC, CAIAI, CAIAM, CAIAU, DAIAC, DIGIT, GAITA, ABACA, AGATI, 72
AGAUA  -->  TAREI, COLUN, SFADA, ABACA, AGAUA, 5
AGAVA  -->  TAREI, COLUN, SAPAM, BAGAJ, ABACA, AGAVA, 6
AGAVE  -->  TAREI, SALCE, POUND, BAGAM, AGAVE, 5
AGENT  -->  TAREI, SALTA, TANCE, TANAT, GENOM, ABNEG, ABCES, ABONA, AGENT, 9
AGERA  -->  TAREI, MARSE, CARDA, PEREN, GEREZ, AEREZ, ACREA, ACREI, AGENT, AGERA, 10
AGERE  -->  TAREI, MARSE, BOARD, PLACU, AGAVA, AGERE, 6
AGERI  -->  TAREI, ACREA, PEDES, FIREZ, GREAM, AGERI, 6
AGEST  -->  TAREI, SALTA, SECTA, SPETA, AGONA, AGEST, 6
AGHII  -->  TAREI, SACAL, MANAU, ZAPAJ, GHIOB, ABACA, AGHII, 7
AGIEI  -->  TAREI, MALOS, VANDU, GOPAC, ABUZA, AGIEI, 6
AGILA  -->  TAREI, SALCI, MULII, PANII, BOLII, VIGII, ACIDA, AGILA, 8
AGILE  -->  TAREI, MASLE, ABNEG, AGILE, 4
AGILI  -->  TAREI, SACAL, ALBUM, EVING, AGILI, 5
AGITA  -->  TAREI, SANTI, CAULA, OVISM, GABIA, ABACA, AGITA, 7
AGITE  -->  TAREI, LATEA, CATEA, PATEA, VAITE, ABNEG, AGITE, 7
AGITI  -->  TAREI, CATAU, PANAS, BATAL, VATAM, TOIAG, AGITI, 7
AGIUL  -->  TAREI, SALCI, MULII, PADII, LABII, FAZII, GAINI, AGIUL, 8
AGNAT  -->  TAREI, SOCUL, TAMAN, BANAT, HAVEZ, AFGAN, AGNAT, 7
AGNET  -->  TAREI, SALCA, PATMA, BATOG, GABJA, ABUZA, AGNET, 7
AGONA  -->  TAREI, COLUN, SAMAN, BOGZA, ABACA, AGONA, 6
AGONE  -->  TAREI, SALCE, POUND, ABNEG, AGONE, 5
AGORA  -->  TAREI, MORUA, BOARD, FRANC, AGAPA, AGORA, 6
AGORE  -->  TAREI, MARSE, BOARD, GRUPA, AGORE, 5
AGRAI  -->  TAREI, CUBAM, GAVAN, AICEA, AGRAI, 5
AGRAR  -->  TAREI, CUMAS, BAZON, GHIDA, ABACA, AGRAR, 6
AGREA  -->  TAREI, CAZMA, DANOS, GAJUL, AGREA, 5
AGRIS  -->  TAREI, MUCII, BASNI, ABATI, AGRIS, 5
AGUDA  -->  TAREI, COLUN, SAPAM, GAZDA, AGUDA, 5
AGUDE  -->  TAREI, SALCE, POUND, AGUDE, 4
AGUZI  -->  TAREI, SACAL, MANAU, PAUZA, ABACA, AGUZI, 6
AHEII  -->  TAREI, MASLU, VADAN, GOPAC, BARIZ, AHEII, 6
AHEUL  -->  TAREI, SALCE, POLUA, ABDIC, AHEUL, 5
AHTIA  -->  TAREI, SANTI, CAUTI, LAPAI, TAMAI, BAIAI, VOIAI, GATAI, HIOID, ABACA, AHTIA, 11
AHTIE  -->  TAREI, LATEA, CAVEI, SABIA, ABONA, AHTIE, 6
AHTUL  -->  TAREI, SOCUL, PATAM, BAHNA, ABACA, AHTUL, 6
AHURI  -->  TAREI, CARUB, UZUAL, AMHAR, AHURI, 5
AICEA  -->  TAREI, MALOS, DANCI, ARCUI, AICEA, 5
AIDAM  -->  TAREI, SALCI, MANAU, BAZOI, PADII, ABACA, AIDAM, 7
AIDEM  -->  TAREI, MALOS, MAIND, ABDIC, AIDEM, 5
AIEPT  -->  TAREI, LATEA, CATEA, PATEA, CITET, AIEPT, 6
AIEST  -->  TAREI, LATEA, CATEA, PATEA, VAITE, ATITA, STATI, ABATI, ABTIE, ACATI, ACEEA, AIEST, 12
AIEVE  -->  TAREI, MASLE, CAIND, AVIZO, AIEVE, 5
AILOR  -->  TAREI, CURII, MORII, SOBRI, ARIDA, AILOR, 6
AIORI  -->  TAREI, CARUB, GAMAN, PROIS, ABDIC, AIORI, 6
AISOR  -->  TAREI, CURII, MORII, SOBRI, ABILA, AISOR, 6
AISTA  -->  TAREI, SANTI, SIPCA, ALIAM, AISTA, 5
AISTE  -->  TAREI, LATEA, CATEA, PATEA, VAITE, AGASA, AISTE, 7
AISTI  -->  TAREI, CATAU, PANAS, SABAC, SALAM, SAVAI, SACAZ, SAFAR, SAHAN, ATRAG, ABATA, AISTI, 12
AIURA  -->  TAREI, CURII, BURAI, GURAI, PARAI, MURAI, DURAI, LUARI, ASUZI, CIHAI, ABACA, AIURA, 12
AIURE  -->  TAREI, CARIE, BARIM, FLUID, AIURE, 5
AIURI  -->  TAREI, CARUB, UZUAL, AMHAR, AFIXE, AIURI, 6
AJUNA  -->  TAREI, COLUN, FANDA, SPANZ, ABACA, AJUNA, 6
AJUNG  -->  TAREI, COLUN, FANDA, SPUMA, ABACA, ABATA, ABAUA, ABILA, ABNEG, AJUNG, 10
AJUNS  -->  TAREI, COLUN, FANDA, SPUMA, ABACA, AJUNS, 6
AJURA  -->  TAREI, MORUA, BRUSC, GRUNZ, PAJUL, AJURA, 6
AJUTA  -->  TAREI, SOCUL, MANAT, BATAJ, ABACA, AJUTA, 6
AJUTE  -->  TAREI, SALTA, UBACE, ADORM, ABJUR, AJUTE, 6
AJUTI  -->  TAREI, CATAU, TUSUL, BUTAN, HAVAM, TOIAG, FIUTI, AJUTI, 8
AKANI  -->  TAREI, SACAL, MANAU, PONIV, DANIA, FANII, HANII, ABNEG, ABACA, AKANI, 10
ALACE  -->  TAREI, SALCE, CAPON, AFANA, ALACE, 5
ALAIT  -->  TAREI, SANTI, CAUTI, LAPAI, TATII, LAMAT, FLASH, ALAIT, 8
ALAMA  -->  TAREI, COLUN, SAMBA, ADAPA, ALAMA, 5
ALAME  -->  TAREI, SALCE, PLUMB, ABACA, ALAME, 5
ALAMI  -->  TAREI, SACAL, ALBUM, ALAMI, 4
ALANA  -->  TAREI, COLUN, BASNA, ADAPA, ALANA, 5
ALANE  -->  TAREI, SALCE, PLUMB, AFGAN, ABACA, ALANE, 6
ALANI  -->  TAREI, SACAL, ALBUM, ARIAN, ABACA, ALANI, 6
ALAUN  -->  TAREI, COLUN, ABACA, ALAUN, 4
ALBEA  -->  TAREI, CALUS, GALOP, JALBA, ABACA, ALBEA, 6
ALBEI  -->  TAREI, MALOS, BALAC, ACLAM, ALBEI, 5
ALBET  -->  TAREI, SALCA, GALBA, ACTUL, ALBET, 5
ALBIA  -->  TAREI, SALCI, MULII, DALBI, LADOI, LABEI, AKANI, ABACA, ALBIA, 9
ALBIE  -->  TAREI, MASLE, BAZIC, ACLAM, ALBIE, 5
ALBII  -->  TAREI, SACAL, ALBUM, ALBII, 4
ALBIM  -->  TAREI, SALCI, MULII, MAHNI, CALPI, FALCI, ANOZI, ALBIM, 8
ALBIT  -->  TAREI, SANTI, CAUTI, LAPAI, TATII, LAMAT, FLASH, ABACA, ALBIT, 9
ALBIU  -->  TAREI, SALCI, MULII, GALOP, VALFA, ABUZA, ALBIU, 7
ALBUI  -->  TAREI, SACAL, ALBUM, ALBUI, 4
ALBUL  -->  TAREI, COLUN, GALES, ZAPAJ, FALIM, HALBA, AFLUX, ALBUL, 8
ALBUM  -->  TAREI, COLUN, GALES, ZAPAJ, FALIM, ALBUM, 6
ALBUS  -->  TAREI, COLUN, GALES, ADAPA, ALBUS, 5
ALBUT  -->  TAREI, SOCUL, TAPUL, BATEM, ABTIE, ALBUT, 6
ALCAN  -->  TAREI, COLUN, ALCAN, 3
ALCOV  -->  TAREI, COLUN, COPAL, BOCAL, CAVAF, ABACA, ALCOV, 7
ALDAN  -->  TAREI, COLUN, ALBEA, ALDAN, 4
ALDIN  -->  TAREI, SALCI, MULII, DALBI, GALOP, DADEA, ABACA, ALDIN, 8
ALDOL  -->  TAREI, COLUN, SOLBA, ZOLGA, DOPAM, ABACA, ALDOL, 7
ALDUI  -->  TAREI, SACAL, ALBUM, ALDUI, 4
ALEAN  -->  TAREI, SALCE, POLUA, GEANA, ALBEA, ACANA, AFANA, ALANA, ALANE, ABONA, ACINE, ADUNA, ADUNE, AFINA, AFINE, AFONA, AFONE, AGONA, AGONE, AJUNA, ALENA, ABACE, ABALE, ABATE, ABILE, ABRAC, ALEAN, 27
ALEEA  -->  TAREI, CALUS, GALOP, JALBA, VALFA, BELIM, FELAH, BALAN, AEDUL, ALEEA, 10
ALEGA  -->  TAREI, SALCE, POLUA, GEMEN, AGALE, ALEGA, 6
ALEGE  -->  TAREI, SALCE, PLUMB, AFGAN, ALEGE, 5
ALEGI  -->  TAREI, MASLU, LAGON, ELEAT, ALEGI, 5
ALEIA  -->  TAREI, MASLE, LAILE, LABIE, PLEDA, ABATU, ALEIA, 7
ALEII  -->  TAREI, MASLU, LAGON, LOBEZ, LAPAD, LAVAJ, LEXIC, ALEII, 8
ALELA  -->  TAREI, SALCE, POLUA, GEMEN, LAVEI, FEELE, ALELA, 7
ALELE  -->  TAREI, SALCE, PLUMB, AFGAN, ABALE, ALELE, 6
ALENA  -->  TAREI, SALCE, POLUA, GEMEN, ACEEA, ALENA, 6
ALENE  -->  TAREI, SALCE, PLUMB, AFGAN, ABACA, ABACE, ABALE, ABATA, ABATE, ABATI, ABATU, ABAUA, ACAJU, ACANA, ACANI, ACANT, ACARE, ACARI, ACASA, ACATA, ACATE, ACATI, ACEEA, ALENE, 24
ALERG  -->  TAREI, MARSE, CARDA, BERNA, PURGA, AVELE, ALERG, 7
ALERT  -->  TAREI, TARTE, TARSE, TARTA, TERTA, CARTE, TAREA, TERTE, TARFE, TARLE, ACTOR, ACTUL, AFTOR, AHEUL, ALERT, 15
ALESE  -->  TAREI, SALCE, NAVLU, SPELB, ALESE, 5
ALESI  -->  TAREI, MASLU, ABACA, ALESI, 4
ALEZA  -->  TAREI, SALCE, POLUA, GEMEN, LAVEI, FEELE, AEREZ, ALEZA, 8
ALEZE  -->  TAREI, SALCE, PLUMB, AFGAN, ABALE, ABILA, ABILE, ABILI, ABOLI, ABUZA, ALEZE, 11
ALGEI  -->  TAREI, MALOS, BALAC, FULGI, ABACA, ALGEI, 6
ALGIA  -->  TAREI, SALCI, MULII, DALBI, GALOP, ABATI, ABACA, ALGIA, 8
ALGID  -->  TAREI, SALCI, MULII, DALBI, GALOP, ABACA, ALGID, 7
ALGIE  -->  TAREI, MASLE, BAZIC, APLEC, ABNEG, ALGIE, 6
ALGII  -->  TAREI, SACAL, ALBUM, ARIAN, ADIAI, ADIAM, ADIAT, ADIAU, AFGAN, ALGII, 10
ALGOL  -->  TAREI, COLUN, SOLBA, ZOLGA, ABACA, ALGOL, 6
ALIAI  -->  TAREI, SACAL, LIMFO, LIPUL, CHIBZ, ALIAI, 6
ALIAJ  -->  TAREI, SALCI, MULII, PANII, BOLII, VIGII, FILAI, HLIZI, ABATI, ABILI, ABJUR, ALIAJ, 12
ALIAM  -->  TAREI, SALCI, MULII, MALAI, LIPOM, ABUZA, ALIAM, 7
ALIAS  -->  TAREI, SALCI, SAPAI, SILUI, SILIM, SALAS, ABACA, ALIAS, 8
ALIAT  -->  TAREI, SANTI, CAUTI, LAPAI, AFLAT, ALIAT, 6
ALIAU  -->  TAREI, SALCI, MULII, PADII, LABII, FAZII, GAINI, GHIUJ, ABACA, ALIAU, 10
ALIBI  -->  TAREI, SACAL, ALBUM, ABDIC, ABILA, ALIBI, 6
ALICA  -->  TAREI, SALCI, CLIMA, ADAPA, ALICA, 5
ALICE  -->  TAREI, MASLE, BAZIC, ABACA, ALICE, 5
ALICI  -->  TAREI, SACAL, CALIM, CALCA, CLING, ALICI, 6
ALIEM  -->  TAREI, MALOS, ABATI, ABILA, ALIEM, 5
ALIEZ  -->  TAREI, MALOS, DALBA, CALPI, FULGI, HALON, LAVAJ, LUXEZ, ALIEZ, 9
ALINA  -->  TAREI, SALCI, MULII, PANII, ALBIA, ALINA, 6
ALINE  -->  TAREI, MASLE, BAZIC, PAING, ALINE, 5
ALINI  -->  TAREI, SACAL, ALBUM, ARIAN, ALINI, 5
ALINT  -->  TAREI, SANTI, TANAI, TANTI, TANAT, ILIAC, ALINT, 7
ALIOR  -->  TAREI, CURII, MORII, SOBRI, ARIDA, ALIOR, 6
ALIPI  -->  TAREI, SACAL, ALBUM, ARIAN, ABRAC, ABRAS, ACLAM, ADAPA, ALIPI, 9
ALMAR  -->  TAREI, MORUA, SARAC, NAMIM, ACLAM, ALMAR, 6
ALMEE  -->  TAREI, CALUS, GALOP, JALBA, LARVA, FALIM, ABACA, ALMEE, 8
ALMEI  -->  TAREI, MALOS, ABACA, ALMEI, 4
ALOCA  -->  TAREI, COLUN, COPAL, BOCAL, COLAM, SOLVA, ABOLI, ALOCA, 8
ALOCE  -->  TAREI, SALCE, CAPON, ABACA, ALOCE, 5
ALOCI  -->  TAREI, SACAL, CALIM, CALCA, CLING, APOZI, ALOCI, 7
ALOEA  -->  TAREI, CALUS, GALOP, ABUZA, ALOEA, 5
ALOEI  -->  TAREI, MALOS, ABACA, ALOEI, 4
ALORA  -->  TAREI, MORUA, BOARD, FRANC, AGAPA, ALORA, 6
ALOUL  -->  TAREI, COLUN, ABONA, ALOUL, 4
ALPIN  -->  TAREI, SALCI, MULII, DALBI, GALOP, AMPLA, ALPIN, 7
ALTAR  -->  TAREI, CURAT, HORST, MARET, BARAT, NARAT, GARAT, TARLA, ABACA, ALTAR, 10
ALTEI  -->  TAREI, FATAL, ABACA, ALTEI, 4
ALTER  -->  TAREI, RATUL, ABJUR, ALTER, 4
ALTII  -->  TAREI, CATAU, DOPAM, HABAN, TAGAI, TALAJ, ABACA, ALTII, 8
ALTOI  -->  TAREI, CATAU, DOPAM, AFGAN, ALTOI, 5
ALTOR  -->  TAREI, CURAT, SARAT, FORAT, DORNA, TOLBA, ABJUR, ALTOR, 8
ALTUI  -->  TAREI, CATAU, FAGAS, BUHAV, ACLAM, ALTUI, 6
ALTUL  -->  TAREI, SOCUL, PATAM, BAHNA, GAFEZ, ALDAN, ALTUL, 7
ALUAT  -->  TAREI, SOCUL, PATUT, AFLAM, ALUAT, 5
ALUIA  -->  TAREI, SALCI, MULII, GALOP, VALFA, ABUZA, ALUIA, 7
ALUNA  -->  TAREI, COLUN, PANUL, LASUL, DANUL, NUNUL, BANUL, FANAL, HANUL, LANUL, ANAUA, ABALE, ABILA, ABILE, ABILI, ABOLI, ABONA, ALUNA, 18
ALUNE  -->  TAREI, SALCE, PLUMB, ALUNE, 4
ALUNG  -->  TAREI, COLUN, PANUL, LASUL, DANUL, NUNUL, BANUL, FANAL, HANUL, LANUL, ANAUA, ACANA, ABACA, ABATA, ABAUA, ABILA, ABNEG, ALUNG, 18
ALUNI  -->  TAREI, SACAL, ALBUM, ABAUA, ABDIC, ALUNI, 6
ALURA  -->  TAREI, MORUA, BRUSC, GRUNZ, PAJUL, ABACA, ALURA, 7
ALURI  -->  TAREI, CARUB, UZUAL, ABACA, ALURI, 5
AMAGI  -->  TAREI, SACAL, MANAU, ZAMBO, GAVAJ, ABDIC, AMAGI, 7
AMANA  -->  TAREI, COLUN, MANSA, AJUNG, AMANA, 5
AMANE  -->  TAREI, SALCE, POUND, AMHAR, AMANE, 5
AMANI  -->  TAREI, SACAL, MANAU, MAINA, ADAOG, AMANI, 6
AMANT  -->  TAREI, SOCUL, TAMAN, ADIAT, AMANT, 5
AMARA  -->  TAREI, MORUA, MASCA, DARMA, FARMA, ALAMA, ABURC, AMARA, 8
AMARE  -->  TAREI, MARSE, MACRO, ABACA, AMARE, 5
AMARI  -->  TAREI, CARUB, GAMAN, FARAD, VARIO, LAMAI, RAMAI, ARMAI, ACARE, AMARI, 10
AMBAR  -->  TAREI, MORUA, SARAC, NAMIM, HARAM, GARAM, BARAM, AMBAR, 8
AMBII  -->  TAREI, SACAL, MANAU, ZAMBO, ABACA, AMBII, 6
AMBRA  -->  TAREI, MORUA, MASCA, DARMA, FARMA, ALAMA, ABURC, AMBRA, 8
AMBRE  -->  TAREI, MARSE, MACRO, ABACA, AMBRE, 5
AMENT  -->  TAREI, SALTA, TANCE, TANAT, GENOM, ABACA, AMENT, 7
AMETI  -->  TAREI, FATAL, BATEM, ABACA, AMETI, 5
AMHAR  -->  TAREI, MORUA, SARAC, NAMIM, HARAM, ABACA, AMHAR, 7
AMIAZ  -->  TAREI, SALCI, MANAU, BAZOI, AVAMI, AMIAZ, 6
AMIBA  -->  TAREI, SALCI, MANAU, MIZAI, MIGAI, MADAM, MAFII, PABAI, BOJII, ABILA, AMIBA, 11
AMIBE  -->  TAREI, MASLE, CAIND, ABACA, AMIBE, 5
AMICA  -->  TAREI, SALCI, MUNDI, ABILA, AMICA, 5
AMICE  -->  TAREI, MASLE, CAIND, ABACA, AMICE, 5
AMICI  -->  TAREI, SACAL, CAPAU, CANIM, MACAC, MACAI, MACHE, ACCIZ, AMICI, 9
AMIDA  -->  TAREI, SALCI, MANAU, MIZAI, MIGAI, MADAM, AUDIA, AMIDA, 8
AMIDE  -->  TAREI, MASLE, CAIND, AMIDE, 4
AMIEZ  -->  TAREI, MALOS, MAIND, ABATI, AMIEZ, 5
AMILI  -->  TAREI, SACAL, ALBUM, ABILA, AMILI, 5
AMINA  -->  TAREI, SALCI, MANAU, MAINA, ABACA, AMINA, 6
AMINE  -->  TAREI, MASLE, CAIND, ABACA, AMINE, 5
AMINO  -->  TAREI, SALCI, MANAU, MAINA, ABOLI, AMINO, 6
AMNAR  -->  TAREI, MORUA, SARAC, NAMIM, ARMAM, ABJUR, AMNAR, 7
AMORF  -->  TAREI, MORUA, MORNA, MORSA, MORVA, MARDA, MARCA, MARFA, ABACA, AMORF, 10
AMPER  -->  TAREI, CARDA, MARSA, MARAZ, MARGA, MARJE, HARPA, ABACA, AMPER, 9
AMPEX  -->  TAREI, CALUS, DANGA, PAVEZ, ABACA, AMPEX, 6
AMPLA  -->  TAREI, COLUN, SAMBA, ADAPA, AMPLA, 5
AMPLE  -->  TAREI, SALCE, PLUMB, ABACA, AMPLE, 5
AMPLI  -->  TAREI, SACAL, ALBUM, ABILA, ABILE, ABILI, ACIDA, ACIDE, ACILA, ACILI, ACINE, ACIRA, ACIRE, ACIRI, ACIUA, ACIUI, ACIZI, ADAPA, AMPLI, 19
AMPLU  -->  TAREI, COLUN, SALAM, MADAM, GUMAM, MANAM, MASAM, MASLU, AMPLU, 9
AMURG  -->  TAREI, MORUA, MULAM, MUCAR, MURSA, RUMBA, RUJAM, MURAM, RUGAM, ACUMA, AMURG, 11
AMUSA  -->  TAREI, COLUN, SAPAM, GUMAM, FUMAM, FUMAU, GUMAU, LAMAM, LAMAU, LUSAM, LUSAU, MUSAU, ARMAM, ACASA, AMUSA, 15
AMUSE  -->  TAREI, SALCE, SOUND, AMPER, AMUSE, 5
AMUSI  -->  TAREI, SACAL, SAPAU, SAMAN, ASMUT, ACASA, AMUSI, 7
AMUTA  -->  TAREI, SOCUL, MANAT, MAMUT, MUTAT, MATAM, MUTAM, FAMAT, BAZAT, FUMAT, GAMAN, BAHLA, AMUTA, 13
AMUTE  -->  TAREI, SALTA, UBACE, ADORM, AMUTE, 5
AMUTI  -->  TAREI, CATAU, TUSUL, BUTAN, HAVAM, ABACA, AMUTI, 7
AMUZA  -->  TAREI, COLUN, SAPAM, BIFAM, ACAJU, AMUZA, 6
AMUZE  -->  TAREI, SALCE, POUND, ABUZA, AMUZE, 5
AMUZI  -->  TAREI, SACAL, MANAU, CAVAF, ACIUA, AMUZI, 6
AMVON  -->  TAREI, COLUN, PASAM, ALMAR, AMVON, 5
ANALA  -->  TAREI, COLUN, BASNA, AFUND, ABALE, ANALA, 6
ANALE  -->  TAREI, SALCE, PLUMB, GOANA, ABALE, ANALE, 6
ANALI  -->  TAREI, SACAL, ALBUM, EVING, ABALE, ANALI, 6
ANAUA  -->  TAREI, COLUN, FASON, ABACA, ANAUA, 5
ANCIA  -->  TAREI, SALCI, CAUNI, CANII, MUNDA, ANCIA, 6
ANCIE  -->  TAREI, MASLE, CAIND, ABCES, ANCIE, 5
ANCII  -->  TAREI, SACAL, PAMAU, BAGAJ, CANID, ANCII, 6
ANDIN  -->  TAREI, SALCI, MANAU, PODII, ANDIN, 5
ANEXA  -->  TAREI, SALCE, MUNDA, ZBENG, ABONA, ACANA, ACANI, ACANT, ACINE, ACONT, ACTIV, ANEXA, 12
ANEXE  -->  TAREI, SALCE, POUND, AMANA, ACANA, ACANI, ACANT, ADANC, AFANA, AGAVA, ANEXE, 11
ANGLI  -->  TAREI, SACAL, ALBUM, EVING, ANGLI, 5
ANGOR  -->  TAREI, MORUA, BORNA, ODGON, ABJUR, ANGOR, 6
ANGRO  -->  TAREI, MORUA, BORNA, ODGON, ACTOR, ADVON, AFION, AFTOR, AILOR, AISOR, ALIOR, ALTOR, AMVON, ANGOR, ANGRO, 15
ANIMA  -->  TAREI, SALCI, MANAU, MAINA, ABONA, ACANA, ACANI, ACANT, ACINE, ACONT, ACUMA, ANIMA, 12
ANIME  -->  TAREI, MASLE, CAIND, ABONA, ACANA, ACANI, ACANT, ACINE, ACONT, ACUMA, ANIME, 11
ANIMI  -->  TAREI, SACAL, MANAU, MAINA, ABONA, ANIMI, 6
ANINA  -->  TAREI, SALCI, MANAU, PODII, VAGII, ZAIFI, ABACA, ANINA, 8
ANINE  -->  TAREI, MASLE, CAIND, AFIPT, ANINE, 5
ANINI  -->  TAREI, SACAL, MANAU, PONIV, DANIA, FANII, HANII, ABNEG, ABACA, ABACE, ABALE, ABATA, ABATE, ABATI, ABATU, ABAUA, ABILA, ANINI, 18
ANION  -->  TAREI, SALCI, MANAU, PODII, NAIVA, FIXAJ, ABACA, ANION, 8
ANOST  -->  TAREI, SOCUL, PATAT, BIMAN, ABACA, ANOST, 6
ANOZI  -->  TAREI, SACAL, MANAU, PONIV, AFUND, ABONA, ABUZA, ANOZI, 8
ANSEI  -->  TAREI, MALOS, CAPAN, ABACA, ANSEI, 5
ANSOA  -->  TAREI, COLUN, SAMAN, BANAN, ADVON, ANSOA, 6
ANTAL  -->  TAREI, SOCUL, TABAN, ABACA, ANTAL, 5
ANTEI  -->  TAREI, FATAL, ABDIC, ADINS, ANTEI, 5
ANTET  -->  TAREI, SALCA, PATMA, BOGZA, FACUT, ANTET, 6
ANTIC  -->  TAREI, SANTI, TANAI, TANTI, TANAT, TANCA, CANIT, ABACA, ANTIC, 9
ANTUM  -->  TAREI, SOCUL, MANAT, ANTUM, 4
ANUAL  -->  TAREI, COLUN, PANUL, NABUS, NADUF, HAVAM, ANUAL, 7
ANUAR  -->  TAREI, MORUA, SULAC, BUJOR, FUNDA, ABACA, ANUAR, 7
ANULA  -->  TAREI, COLUN, PANUL, LASUL, DANUL, NUNUL, BANUL, FANAL, HANUL, LANUL, ANAUA, ANULA, 12
ANUME  -->  TAREI, SALCE, POUND, ABACA, ANUME, 5
ANUNT  -->  TAREI, SOCUL, MANAT, ADNAT, ANUNT, 5
ANURA  -->  TAREI, MORUA, BRUSC, GRUNZ, ACTIV, ANURA, 6
ANURE  -->  TAREI, MARSE, BOARD, PLACU, ABUZA, ANURE, 6
AOLEO  -->  TAREI, CALUS, GABJA, LAMPA, LARVA, LAUZA, HARFA, AEDUL, AOLEO, 9
AOLEU  -->  TAREI, CALUS, HALOU, AOLEU, 4
AORTA  -->  TAREI, TUSCA, FAPTA, TABAC, TAHAN, ADVON, AORTA, 7
AORTE  -->  TAREI, TAFTA, TOCMA, AORTE, 4
APARA  -->  TAREI, MORUA, SCARP, APARA, 4
APARE  -->  TAREI, MARSE, BOARD, CRUPA, APARE, 5
APARI  -->  TAREI, CARUB, GAMAN, PROIS, PAIAI, PAIAM, PAIAU, PRIAN, PRIAU, PRIIT, PAHAI, PALAN, PARAI, ARIAN, ACARE, APARI, 16
APARU  -->  TAREI, MORUA, SULAC, DUNGA, BARJA, PAUZA, ABRAC, APARU, 8
APASA  -->  TAREI, COLUN, SAPAM, ADAPA, APASA, 5
APASI  -->  TAREI, SACAL, SAPAU, SAPAI, PANSA, AVIZO, APASI, 7
APELA  -->  TAREI, SALCE, POLUA, ABCES, APELA, 5
APELE  -->  TAREI, SALCE, PLUMB, POLEN, PAVEA, BAHLA, APELE, 7
APERE  -->  TAREI, MARSE, BOARD, PLACU, ABACA, ABACE, ABALE, ABATA, ABATE, ABATI, ABATU, ABAUA, ACAJU, ACANA, ACANI, ACANT, ACARE, ACARI, ACASA, ACATA, ACATE, ACATI, ACEEA, APERE, 24
APERI  -->  TAREI, ACREA, PEDES, ABCES, ABNEG, ABURC, APERI, 7
APESE  -->  TAREI, SALCE, SOUND, ASABI, ACASA, ABACA, ABACE, ABALE, ABATA, ABATE, ABATI, ABATU, ABAUA, ACAJU, ACANA, ACANI, ACANT, ACARE, ACARI, ACATA, ACATE, ACATI, ACEEA, APESE, 24
APESI  -->  TAREI, MASLU, CAPAN, AISOR, APESI, 5
APIDA  -->  TAREI, SALCI, MANAU, ZODII, VIPII, ABACA, APIDA, 7
APIDE  -->  TAREI, MASLE, CAIND, GAFEZ, ACTIV, APIDE, 6
APIOL  -->  TAREI, SALCI, MULII, PANII, PAIAI, ABOLI, APIOL, 7
APLEC  -->  TAREI, CALUS, AROMA, APLEC, 4
APLIC  -->  TAREI, SALCI, CAMPI, ABACA, APLIC, 5
APLIT  -->  TAREI, SANTI, CAUTI, LAPAI, PAPAI, BALAI, ABATI, APLIT, 8
APNEE  -->  TAREI, CALUS, DANGA, VAMPA, APNEE, 5
APODA  -->  TAREI, COLUN, SAPAM, ABUZA, APODA, 5
APODE  -->  TAREI, SALCE, POUND, ABACA, APODE, 5
APOLO  -->  TAREI, COLUN, SOLBA, ZOLGA, DOPAM, ABACA, APOLO, 7
APORT  -->  TAREI, CURAT, FORAS, LORAN, BATAV, APROD, APORT, 7
APOSI  -->  TAREI, SACAL, SAPAU, SAPAI, PANSA, AVIZO, APOSI, 7
APOZI  -->  TAREI, SACAL, MANAU, ZAPAJ, ARZOI, APOZI, 6
APRET  -->  TAREI, ACUMA, APRET, 3
APRIG  -->  TAREI, MUCII, BASNI, PLODI, ABACA, APRIG, 6
APRIL  -->  TAREI, MUCII, BASNI, PLODI, APRIL, 5
APROB  -->  TAREI, CUMAS, BOGZA, BACON, APROB, 5
APROD  -->  TAREI, CUMAS, BOGZA, LANDA, ACHII, APROD, 6
APTEI  -->  TAREI, FATAL, ABDIC, ADINS, APTEI, 5
APTER  -->  TAREI, RATUL, MASOR, ABNEG, APTER, 5
APTII  -->  TAREI, CATAU, DOPAM, ABDIC, APTII, 5
APTUL  -->  TAREI, SOCUL, PATAM, ABACA, APTUL, 5
APUCA  -->  TAREI, COLUN, CUSMA, ADUCA, APUCA, 5
APUCE  -->  TAREI, SALCE, POUND, ABACA, APUCE, 5
APUCI  -->  TAREI, SACAL, CAPAU, ABACA, APUCI, 5
APUIE  -->  TAREI, MASLE, CAIND, AVIZO, AFIFA, APUIE, 6
APULI  -->  TAREI, SACAL, ALBUM, ADULA, APULI, 5
APUNA  -->  TAREI, COLUN, FANDA, SPANZ, APUNA, 5
APUNE  -->  TAREI, SALCE, POUND, ABACA, APUNE, 5
APUPA  -->  TAREI, COLUN, SAPAM, PAPUA, ABACA, APUPA, 6
APUPE  -->  TAREI, SALCE, POUND, ABACA, APUPE, 5
APUSA  -->  TAREI, COLUN, SAPAM, SACAZ, SAPAI, SAPAT, SAPAU, SAPUN, SASAI, SASAU, SASEU, SASIU, SUSUI, SUSUL, SUSUR, AMPLU, APUSA, 17
APUSE  -->  TAREI, SALCE, SOUND, AMPER, APUSE, 5
APUSI  -->  TAREI, SACAL, SAPAU, ABAUA, APUSI, 5
ARABA  -->  TAREI, MORUA, SCARP, BENGA, ACHII, ARABA, 6
ARABE  -->  TAREI, MARSE, BOARD, ABNEG, ARABE, 5
ARABI  -->  TAREI, CARUB, BARIZ, BARON, BARIS, BARAI, BARIA, BARIC, BARIE, BARII, BARAJ, BARAM, BARAT, BARAU, BARFA, GAIAL, BAIAI, BAIAM, BAIAN, BAIAS, BAIAT, BAIAU, BRIAI, ABACA, ARABI, 25
ARACI  -->  TAREI, CARUB, CARAS, CARAM, CAPAN, CARCA, AVAND, ARACI, 8
ARAMA  -->  TAREI, MORUA, MASCA, DARMA, KABIL, ABACA, ARAMA, 7
ARAME  -->  TAREI, MARSE, MACRO, DARMA, ABALE, ARAME, 6
ARAMI  -->  TAREI, CARUB, GAMAN, FARAD, VARIO, LAMAI, RAMAI, ARMAI, ABACA, ARAMI, 10
ARAND  -->  TAREI, MORUA, BASCA, VANDA, ABACA, ARAND, 6
ARAPI  -->  TAREI, CARUB, GAMAN, PROIS, ACAJU, ARAPI, 6
ARARA  -->  TAREI, MORUA, SCARP, AFIXE, ACTIV, ARARA, 6
ARARE  -->  TAREI, MARSE, BOARD, CRUPA, ARARE, 5
ARARI  -->  TAREI, CARUB, GAMAN, PROIS, ABALE, ARARI, 6
ARASE  -->  TAREI, MARSE, ARGON, ARASE, 4
ARASI  -->  TAREI, CARUB, GAMAN, PROIS, ABACA, ARASI, 6
ARATA  -->  TAREI, CURAT, SARAT, FORAT, TATAN, TARAM, TARGA, LAPTE, TAHAN, AGAVA, ARATA, 11
ARATE  -->  TAREI, TARTE, FORUM, ABACA, ARATE, 5
ARATI  -->  TAREI, TARAS, TARAC, TARAM, TARAF, TARAU, TARAN, TATAL, HARAG, VARIO, TAPII, ARTAG, ARATI, 13
ARBIE  -->  TAREI, CARIE, BARAM, ARBIE, 4
ARBIU  -->  TAREI, CURII, BURSA, ABUZA, ARBIU, 5
ARBOR  -->  TAREI, MORUA, BORNA, BARSA, BORZA, BORTA, BARBA, GARDA, VORBA, AORTA, ABJUR, ARBOR, 12
ARBUZ  -->  TAREI, MORUA, LACAS, AGAPA, ABACA, ABACE, ABALE, ABATA, ABATE, ABATI, ABATU, ABAUA, ABCES, ABDIC, ABILA, ABILE, ABILI, ABJUR, ARBUZ, 19
ARCAN  -->  TAREI, MORUA, BASCA, CARNA, CRACA, ABDIC, ARCAN, 7
ARCAS  -->  TAREI, MORUA, BASCA, APARA, ARCAS, 5
ARCAT  -->  TAREI, CURAT, ABOLI, ARCAT, 4
ARCEI  -->  TAREI, PAROM, CARDA, ABCES, ARCEI, 5
ARCER  -->  TAREI, CARDA, CARNA, CARPA, CARCA, CAREA, CERCA, CEREA, CARIA, CARJA, CARMA, CAROR, ABACA, ARCER, 14
ARCUI  -->  TAREI, CARUB, ABACA, ARCUI, 4
ARCUL  -->  TAREI, MORUA, LACAS, ABACA, ARCUL, 5
ARCUS  -->  TAREI, MORUA, LACAS, ARCUS, 4
ARDEA  -->  TAREI, CARDA, RADOU, AEDUL, ARDEA, 5
ARDEI  -->  TAREI, PAROM, CARDA, ABDIC, ARDEI, 5
ARDEM  -->  TAREI, CARDA, RADOU, AERAM, ARDEM, 5
ARDIC  -->  TAREI, CURII, SARBI, CARMI, OARDA, ABACA, ARDIC, 7
ARDIL  -->  TAREI, CURII, SARMA, RABDA, RADEA, AORTA, ARDIL, 7
AREAL  -->  TAREI, MARSE, CARDA, BERNA, PURGA, ZOAVA, LEAHA, ABACA, AREAL, 9
ARECI  -->  TAREI, ACREA, ACCED, ACCES, ACEEA, ABACA, ARECI, 7
AREIC  -->  TAREI, CARIE, ABACE, ABALE, ABATE, ABDIC, AREIC, 7
ARENA  -->  TAREI, MARSE, CARDA, PEREN, GAREZ, BANCO, ACRIU, ARENA, 8
ARENE  -->  TAREI, MARSE, BOARD, ZVARL, CRAPA, AFGAN, ARENE, 7
AREST  -->  TAREI, TARTE, TARSE, ABACA, AREST, 5
ARETA  -->  TAREI, TARTE, FRAPA, ABACA, ARETA, 5
ARETE  -->  TAREI, TARTE, FORUM, ABACA, ABACE, ABALE, ABATA, ABATE, ABATI, ABATU, ABAUA, ACAJU, ACANA, ACANI, ACANT, ACARE, ACARI, ACASA, ACATA, ACATE, ACATI, ACEEA, ARETE, 23
ARETI  -->  TAREI, ABATA, ARETI, 3
ARFEI  -->  TAREI, PAROM, CARDA, SAREZ, RAIUL, BAIAN, HAIAI, ABILA, ABILE, ABILI, ACIDA, ACIDE, ACILA, ACILI, ACINE, ACIRA, ACIRE, ACIRI, ACIUA, ACIUI, ACIZI, ADIAI, ADIAM, ADIAT, ADIAU, ADICA, ADIEM, ADINS, AFANA, ARFEI, 30
ARGAT  -->  TAREI, CURAT, BAROS, APRIG, ARGAT, 5
ARGEA  -->  TAREI, CARDA, RUGOS, AEDUL, ARGEA, 5
ARGON  -->  TAREI, MORUA, BORNA, ODGON, ARGON, 5
ARGOS  -->  TAREI, MORUA, BORNA, SOLDA, CAVAS, PAFUG, ARGOS, 7
ARGOU  -->  TAREI, MORUA, BORNA, CARAU, FARAD, ABNEG, ARGOU, 7
ARGUS  -->  TAREI, MORUA, LACAS, APROB, ARGUS, 5
ARHAR  -->  TAREI, MORUA, BASCA, VANDA, GAZAR, ABALE, ARHAR, 7
ARHON  -->  TAREI, MORUA, BORNA, ODGON, ARHON, 5
ARIAN  -->  TAREI, CURII, MORII, PARGI, BARNI, SARII, VARII, DARII, IARZI, HAIAI, ARIAN, 11
ARICI  -->  TAREI, CARUB, CARAS, CARAM, CAPAN, CARCA, AVAND, ABACA, ABACE, ABALE, ABATA, ABATE, ABATI, ABATU, ABAUA, ABILA, ARICI, 17
ARIDA  -->  TAREI, CURII, MORII, PARGI, BARNI, VADII, ZADIA, ABDIC, ARIDA, 9
ARIDE  -->  TAREI, CARIE, BARIM, FLUID, ABDIC, ARIDE, 6
ARIEI  -->  TAREI, PAROM, CARDA, SAREZ, RAIUL, ABACA, ARIEI, 7
ARILE  -->  TAREI, CARIE, BARIM, FLUID, ABACA, ARILE, 6
ARILI  -->  TAREI, CARUB, GAMAN, PROIS, ABALE, ARILI, 6
ARIMA  -->  TAREI, CURII, MORII, MARAI, MARIM, MARIA, AGRIS, ABDIC, ABILA, ARIMA, 10
ARINA  -->  TAREI, CURII, MORII, PARGI, BARNI, ASAZA, ARINA, 7
ARINE  -->  TAREI, CARIE, BARIM, FLUID, PAING, ARINE, 6
ARINI  -->  TAREI, CARUB, GAMAN, NANAS, VARIO, RAJAH, BARNA, ABACA, ARINI, 9
ARIPA  -->  TAREI, CURII, MORII, PARGI, PAISI, ARIPA, 6
ARIPI  -->  TAREI, CARUB, GAMAN, PROIS, ACAJU, ABACA, ABACE, ABALE, ABATA, ABATE, ABATI, ABATU, ABAUA, ABILA, ARIPI, 15
ARIZI  -->  TAREI, CARUB, GAMAN, PROIS, ABALE, ABACA, ABACE, ABATA, ABATE, ABATI, ABATU, ABAUA, ABILA, ARIZI, 14
ARMAI  -->  TAREI, CARUB, GAMAN, AICEA, ARMAI, 5
ARMAM  -->  TAREI, MORUA, SARAC, NAMIM, ABACA, ARMAM, 6
ARMAN  -->  TAREI, MORUA, SARAC, NAMIM, ABACA, ARMAN, 6
ARMAR  -->  TAREI, MORUA, SARAC, NAMIM, ACLAM, ABJUR, ARMAR, 7
ARMAS  -->  TAREI, MORUA, SARAC, ADMIR, ARMAS, 5
ARMAT  -->  TAREI, CURAT, BAROS, APRIG, ARMAT, 5
ARMAU  -->  TAREI, MORUA, MULAM, CURAM, RUJAM, FURAM, RUDIM, SURIM, AURIM, ARMAU, 10
ARMEI  -->  TAREI, PAROM, ABRAC, ARMEI, 4
ARMEZ  -->  TAREI, CARDA, MARSA, MARAZ, ABACA, ARMEZ, 6
ARMIA  -->  TAREI, CURII, SARMA, BAROC, BAMEI, ABACA, ARMIA, 7
ARMIE  -->  TAREI, CARIE, BARAM, ABRAC, ARMIE, 5
ARMII  -->  TAREI, CARUB, GAMAN, AIDAM, ABDIC, ARMII, 6
ARMUL  -->  TAREI, MORUA, LAMEZ, ABACA, ARMUL, 5
ARNEU  -->  TAREI, CARDA, MARSA, ZARNA, BANCA, ABAUA, ARNEU, 7
AROGA  -->  TAREI, MORUA, BOARD, SFARC, OGORA, ABURC, ABURI, ACARE, ACARI, ACERA, ACERB, ACERE, ACERI, ACIRA, ACIRE, ACIRI, ACORD, ADERA, ADERE, ADERI, ADORA, ADORE, ADORI, ADORM, AFARA, AFIRM, AFURC, AGALE, AGAPA, AGAPE, AGASA, AGATA, AGATE, AGATI, AGAUA, AGAVA, AGAVE, AGENT, AGERA, AGERE, AGERI, AGEST, AGHII, AGIEI, AGILA, AGILE, AGILI, AGITA, AGITE, AGITI, AGIUL, AGNAT, AGNET, AGONA, AGONE, AGORA, AROGA, 57
AROGE  -->  TAREI, MARSE, BOARD, GRAUL, AROGE, 5
AROGI  -->  TAREI, CARUB, GAMAN, GANAS, GAFAI, GAGAI, GAGAT, GARAI, VARIO, ABACA, AROGI, 11
AROMA  -->  TAREI, MORUA, NORMA, ABRAC, AROMA, 5
AROME  -->  TAREI, MARSE, MACRO, ABACA, AROME, 5
AROMI  -->  TAREI, CARUB, GAMAN, FARAD, VARIO, ABOLI, AROMI, 7
ARPEI  -->  TAREI, PAROM, ABRAC, ARPEI, 4
ARSEI  -->  TAREI, PAROM, CARDA, SAREZ, ABACA, ARSEI, 6
ARSEN  -->  TAREI, CARDA, MARSA, ZORUL, ABACA, ARSEN, 6
ARSIC  -->  TAREI, CURII, SARBI, ABDIC, ARSIC, 5
ARSII  -->  TAREI, CARUB, GAMAN, PROIS, ARSII, 5
ARSIN  -->  TAREI, CURII, SARMA, BARNI, ABACA, ARSIN, 6
ARSUL  -->  TAREI, MORUA, LACAS, ABRAC, ARSUL, 5
ARTAG  -->  TAREI, CURAT, HORST, MARET, BARAT, NARAT, GARAT, ABROG, ABRAC, ABRAS, ABTIE, ARTAG, 12
ARTAR  -->  TAREI, CURAT, HORST, MARET, BARAT, NARAT, GARAT, TARLA, TARAF, TAROD, APRET, ARTAR, 12
ARTEI  -->  TAREI, ABACA, ARTEI, 3
ARTEL  -->  TAREI, RATUL, ARTEL, 3
ARTOS  -->  TAREI, CURAT, SARAT, SAROS, ABACA, ARTOS, 6
ARUNC  -->  TAREI, MORUA, SULAC, ABNEG, ARUNC, 5
ARZOI  -->  TAREI, CARUB, GAMAN, PROIS, ABALE, ARZOI, 6
ARZOS  -->  TAREI, MORUA, BORNA, SOLDA, CAVAS, PAFUG, ABACA, ARZOS, 8
ARZUL  -->  TAREI, MORUA, LACAS, PAREZ, ABRAC, ARZUL, 6
ASABI  -->  TAREI, SACAL, SAPAU, SABIN, SASAI, SASAU, SASIA, SASIE, SASII, SASIU, SASCA, SASCE, SASEA, SASEU, SASLA, SASTI, SASUL, BACII, BACIL, BACIT, BADIA, BADIC, BADIE, BADII, BAHIC, BAIAI, BAIAM, BAIAN, BAIAS, BAIAT, BAIAU, BALIA, BALIC, BALIE, BALII, BANIA, BANIE, BANII, BANIM, BANIT, BARIA, BARIC, BARIE, BARII, BARIL, BARIM, BARIS, BARIU, BARIZ, BASIC, BASII, BATAV, AMBAR, ASABI, 54
ASALT  -->  TAREI, SOCUL, PAMAT, ABACA, ASALT, 5
ASANA  -->  TAREI, COLUN, MANSA, STAND, ABACA, ASANA, 6
ASARA  -->  TAREI, MORUA, SCARP, ABACA, ASARA, 5
ASASI  -->  TAREI, SACAL, SAPAU, SABIN, SFIAM, SASAI, VAIAG, SASAU, SAHAN, SOSIA, SARAD, ASSAI, ASASI, 13
ASAZA  -->  TAREI, COLUN, SAPAM, GAFEZ, ASAZA, 5
ASCEI  -->  TAREI, MALOS, CAPAN, ABACA, ASCEI, 5
ASCET  -->  TAREI, SALCA, ABACA, ASCET, 4
ASCUT  -->  TAREI, SOCUL, ASCUT, 3
ASECA  -->  TAREI, SALCE, AVAMA, ASECA, 4
ASECE  -->  TAREI, SALCE, SAMBA, ACTIV, ASECE, 5
ASECI  -->  TAREI, MASLU, CAPAN, ABCES, ABACA, ASECI, 6
ASEZA  -->  TAREI, SALCE, MUNDA, PESOS, DEGER, AEREZ, ASEZA, 7
ASEZE  -->  TAREI, SALCE, SOUND, ASABI, ASEZE, 5
ASEZI  -->  TAREI, MASLU, CAPAN, DEFEL, ABNEG, ASEZI, 6
ASIAT  -->  TAREI, SANTI, SASTI, SUITI, COMAT, ASIAT, 6
ASINI  -->  TAREI, SACAL, SAPAU, SABIN, MANGO, ABNEG, ASINI, 7
ASIST  -->  TAREI, SANTI, SASTI, SUITI, COMAT, ABRAC, ABRAS, ACASA, ASIST, 9
ASIZA  -->  TAREI, SALCI, SUPAI, SANII, MASAI, SABAI, SASAI, FASAI, SASII, SAVAI, SAIGI, ABOLI, ASIZA, 13
ASIZE  -->  TAREI, MASLE, SAFIC, SABIN, ADAST, ABATU, ASIZE, 7
ASMUT  -->  TAREI, SOCUL, NATIV, ABTIE, ABTII, ABTIN, ABTIU, ACANT, ASMUT, 9
ASPIC  -->  TAREI, SALCI, SACII, NASUC, DASEM, ABACA, ASPIC, 7
ASPIR  -->  TAREI, CURII, SARMA, BARNI, RAREI, RARII, BARFI, CARPI, ASPIR, 9
ASPRA  -->  TAREI, MORUA, SCARP, ASPRA, 4
ASPRE  -->  TAREI, MARSE, SPARG, ASPRE, 4
ASPRI  -->  TAREI, CARUB, GAMAN, PROIS, ABACA, ASPRI, 6
ASPRU  -->  TAREI, MORUA, SULAC, SURPA, ABAUA, ASPRU, 6
ASSAI  -->  TAREI, SACAL, SAPUN, FAVOR, SAMBA, SABAC, SABAI, SABAR, SABAS, SABAT, SABAU, SABIA, SABIE, SABII, SABIN, SABIR, SABLA, SABOT, SABUI, SABUR, SABUS, SACAI, SACAZ, SACII, SACOI, SACOS, SACOU, SACRA, SACRE, SACRI, SACRU, SACUI, SACUL, SADEA, SADEI, SADEM, SADIC, SADII, SADIM, SADIT, SADUL, SAFAR, SAFEU, SAFIC, SAFIR, SAGII, SAGNA, SAGNE, SAGNI, SAGUI, SAGUM, SAHAN, AICEA, ASSAI, 54
ASTEA  -->  TAREI, SALCA, ASTRU, ASTEA, 4
ASTEI  -->  TAREI, FATAL, ABDIC, ADINS, ASTEI, 5
ASTIA  -->  TAREI, SANTI, SASTI, SUITI, SIITA, SILIM, AOLEO, ASTIA, 8
ASTMA  -->  TAREI, SOCUL, TAMPA, ABATA, ASTMA, 5
ASTME  -->  TAREI, SALTA, SECTA, SPETA, SANTA, SUETA, SOATA, TESEM, ABATA, ASTME, 10
ASTOR  -->  TAREI, CURAT, SARAT, SAROS, ABCES, ABJUR, ASTOR, 7
ASTRE  -->  TAREI, TARTE, SFARC, ABACA, ASTRE, 5
ASTRI  -->  TAREI, TARAS, ATASA, ASTRI, 4
ASTRU  -->  TAREI, CURAT, TURLA, TURBA, TARAM, TARAS, BATAT, ABAUA, ASTRU, 9
ASTUI  -->  TAREI, CATAU, FAGAS, ABAUA, ASTUI, 5
ASTUP  -->  TAREI, SOCUL, NATIV, ABACA, ASTUP, 5
ASUDA  -->  TAREI, COLUN, SAPAM, DUBAS, BUJDA, ASUDA, 6
ASUDE  -->  TAREI, SALCE, SOUND, ACASA, ACEST, ACIDA, ASUDE, 7
ASUMA  -->  TAREI, COLUN, SAPAM, GUMAM, FUMAM, FUMAU, GUMAU, LAMAM, LAMAU, LUSAM, LUSAU, MUSAU, ARMAM, ACASA, ACEST, ACUMA, ASUMA, 17
ASUME  -->  TAREI, SALCE, SOUND, AMPER, ACASA, ACEST, ACUMA, ASUME, 8
ASUMI  -->  TAREI, SACAL, SAPAU, SAMAN, ASMUT, ASUMI, 6
ASUZI  -->  TAREI, SACAL, SAPAU, SAMAN, ADAUG, ABUZA, ASUZI, 7
ATACA  -->  TAREI, SOCUL, CAPAN, MATCA, ABACA, ATACA, 6
ATACE  -->  TAREI, SALTA, TANCE, AOLEO, ATACE, 5
ATACI  -->  TAREI, CATAU, CANAL, CAIAM, CAIAC, CAIAI, CAIAU, CAITA, CAITE, CAITI, CAFAS, CACAO, TAIAI, TAIAM, TAIAT, TAIAU, CAICE, ABACA, ATACI, 19
ATALE  -->  TAREI, SALTA, LALEA, BALTA, LAUTA, LATEA, TAFTA, HALTA, LEALA, ABONA, ATALE, 11
ATARE  -->  TAREI, TARTE, SFARC, ATARE, 4
ATARI  -->  TAREI, TARAS, TARAC, TARAM, TARAF, TARAU, TARAN, TATAL, HARAG, VARIO, TAPII, ARTAG, ABATA, ABATE, ABATI, ABATU, ABURC, ATARI, 18
ATARN  -->  TAREI, CURAT, SARAT, FORAT, TATAN, ABRAC, ATARN, 7
ATASA  -->  TAREI, SOCUL, TAMPA, SVABA, ABNEG, ATASA, 6
ATASE  -->  TAREI, SALTA, SECTA, SPETA, SANTA, SUETA, SOATA, ATATA, ATASE, 9
ATATA  -->  TAREI, SOCUL, TAMAN, BATAV, PAFUG, AFIXE, ATATA, 7
ATATE  -->  TAREI, SALTA, UBACE, TOPIM, ATING, ATATE, 6
ATATI  -->  TAREI, CATAU, PANAS, BATAL, VATAM, TOIAG, TAXID, HAIAI, TAIAI, STAIF, ATATI, 11
ATAUA  -->  TAREI, SOCUL, MANAT, ABUZA, ATAUA, 5
ATEEA  -->  TAREI, SALCA, TAPAU, BATOG, FATUM, AHTIA, ATEEA, 7
ATEEI  -->  TAREI, FATAL, PATAM, ACTIV, ABTIN, ABCES, ATEEI, 7
ATEII  -->  TAREI, FATAL, BATEM, VATAS, APTEI, ABNEG, ABCES, ABDIC, ATEII, 9
ATELA  -->  TAREI, SALTA, LEUCO, GELEP, ATLET, ATELA, 6
ATELE  -->  TAREI, SALTA, LALEA, BALTA, LAUTA, LATEA, TAFTA, HALTA, LEALA, OTACE, ABACA, ABACE, ABALE, ABATA, ABATE, ABATI, ABATU, ABAUA, ACAJU, ACANA, ACANI, ACANT, ACARE, ACARI, ACASA, ACATA, ACATE, ACATI, ACEEA, ATELE, 30
ATENT  -->  TAREI, SALTA, TANCE, TANAT, GENOM, APNEE, ABCES, ABNEG, ABONA, ATENT, 10
ATEST  -->  TAREI, SALTA, SECTA, SPETA, AGONA, ATEST, 6
ATEUL  -->  TAREI, SALTA, LALEA, BALTA, LAUTA, ABATA, ATEUL, 7
ATICA  -->  TAREI, SANTI, CAUTI, CATII, CAIAI, BAFTA, BAFTE, BAHTI, ABACA, ATICA, 10
ATICE  -->  TAREI, LATEA, CATEA, CETEA, BATEA, CAICE, ATICE, 7
ATICI  -->  TAREI, CATAU, CANAL, CAIAM, ABACA, ATICI, 6
ATINA  -->  TAREI, SANTI, TANAI, TANTI, TANAT, TANCA, TOIND, ABACA, ATINA, 9
ATINE  -->  TAREI, LATEA, CATEA, PATEA, VAITE, ABNEG, ATINE, 7
ATING  -->  TAREI, SANTI, TANAI, TANTI, TANAT, TANCA, TANGA, CITAI, DITAI, GAFAT, GAGAI, GAGAT, GAMAN, GANAS, GARAT, GATAT, GAVAN, GAZAT, GENAT, GIGAI, GINII, GINIT, GINTI, GIRAI, GONAS, MIGAI, RIGAI, TAIAT, ATING, 29
ATINS  -->  TAREI, SANTI, AISTI, ATINS, 4
ATINU  -->  TAREI, SANTI, TANAI, TANTI, TANAT, TANCA, TANGA, TAINA, ABAUA, ATINU, 10
ATIPI  -->  TAREI, CATAU, PANAS, PAPAL, POPIM, FATAI, PAIAI, ABACA, ATIPI, 9
ATITA  -->  TAREI, SANTI, CAULA, OVISM, GABIA, ATIPI, ATITA, 7
ATITE  -->  TAREI, LATEA, CATEA, PATEA, VAITE, ABNEG, ATITE, 7
ATITI  -->  TAREI, CATAU, PANAS, BATAL, VATAM, TOIAG, ABATA, ATITI, 8
ATLAS  -->  TAREI, SOCUL, PAMAT, ABCES, ATLAS, 5
ATLAZ  -->  TAREI, SOCUL, TALAN, MAZUT, ABACA, ATLAZ, 6
ATLET  -->  TAREI, SALCA, GABJA, FACUT, ABACA, ATLET, 6
ATOLI  -->  TAREI, CATAU, PANAS, BATAL, TATOI, ABALE, ATOLI, 7
ATOMA  -->  TAREI, SOCUL, NOPAM, DOTAT, MOLAM, MOLAT, MOTAM, BOTIT, COMAT, COTAT, COTET, COTIT, HOTIT, MOMAI, MOMEA, ABACA, ATOMA, 17
ATOME  -->  TAREI, SALTA, TANCE, JUMBO, ABACA, ATOME, 6
ATOMI  -->  TAREI, CATAU, PANAS, BATAL, VATAM, BOTAU, ABRAC, ATOMI, 8
ATONA  -->  TAREI, SOCUL, NOPAM, FONDA, ABACA, ATONA, 6
ATONE  -->  TAREI, SALTA, TANCE, FOHNE, ABACA, ATONE, 6
ATONI  -->  TAREI, CATAU, PANAS, TONAL, ABACA, ATONI, 6
ATOSI  -->  TAREI, CATAU, PANAS, SABAC, SALAM, SAVAI, SACAZ, SAFAR, SAHAN, ATRAG, ATOSI, 11
ATRAG  -->  TAREI, TUSCA, TAFNA, BOGAT, ABACA, ATRAG, 6
ATRAS  -->  TAREI, TUSCA, CAFAS, ATACA, ATRAS, 5
ATRII  -->  TAREI, TACAN, TESIM, ABACA, ATRII, 5
ATRIU  -->  TAREI, TACIT, ASMUT, ABATU, ATRIU, 5
ATUUL  -->  TAREI, SOCUL, PATAM, HATAN, BATOG, DATEZ, AFTEI, ALTAR, ALTEI, ALTER, ALTII, ALTOI, ALTOR, ALTUI, ALTUL, ABTIE, ABTII, ABTIN, ABTIU, ABURC, ATUUL, 21
AUDIA  -->  TAREI, SALCI, MANAU, PABAI, GUZII, ABACA, AUDIA, 7
AUDIE  -->  TAREI, MASLE, CAIND, FAZII, ABACA, AUDIE, 6
AUDIO  -->  TAREI, SALCI, MANAU, PABAI, GUZII, ABACA, ABATA, ABAUA, ABILA, ABOLI, AUDIO, 11
AUDIT  -->  TAREI, SANTI, CAUTI, TUITI, TOITI, PLIAM, AGITI, ABDIC, AUDIT, 9
AUGUR  -->  TAREI, MORUA, LACAS, AGAPA, AUGUR, 5
AUIAI  -->  TAREI, SACAL, PAION, ALBUM, AUIAI, 5
AUIAM  -->  TAREI, SALCI, MANAU, MIEJI, MIEZI, MIMAI, MIMEI, MIMII, MIXAI, MIGAI, MICEI, MICII, MIDII, MIEII, MIERI, MIJII, MILEI, MILUI, MIMAU, ABILI, AUIAM, 21
AUIAU  -->  TAREI, SALCI, MANAU, BIVOL, HAPAX, ABDIC, AUIAU, 7
AUIND  -->  TAREI, SALCI, MANAU, BUIND, AUIND, 5
AUIRA  -->  TAREI, CURII, AGRAI, AMARA, AUIRA, 5
AUIRE  -->  TAREI, CARIE, BARIM, FLUID, ABURC, ABILA, AUIRE, 7
AUIRI  -->  TAREI, CARUB, UZUAL, FARAD, GARAJ, MAURA, HAIOS, AUIRI, 8
AUISE  -->  TAREI, MASLE, SAFIC, SABIN, ADAST, AUISE, 6
AUISI  -->  TAREI, SACAL, SAPAU, SAMAN, ADAUG, ABUZA, ABILA, AUISI, 8
AUITI  -->  TAREI, CATAU, TUSUL, AMINO, AUITI, 5
AULEI  -->  TAREI, MALOS, ABDIC, AULEI, 4
AULEU  -->  TAREI, CALUS, HALOU, ABACA, AULEU, 5
AULIC  -->  TAREI, SALCI, CAMPI, CANGI, CALIF, ABOLI, AULIC, 7
AULUL  -->  TAREI, COLUN, PASOL, BAGAM, ACHII, AULUL, 6
AURAR  -->  TAREI, CUMAS, DIBLU, ACAJU, AURAR, 5
AUREA  -->  TAREI, CAZMA, DANOS, GAJUL, AUREA, 5
AUREI  -->  TAREI, MACHO, BUDEZ, AUREI, 4
AUREL  -->  TAREI, CAZMA, DANOS, GAJUL, AUREL, 5
AURIA  -->  TAREI, MUCII, AFISA, AURIA, 4
AURIE  -->  TAREI, CAPEI, HADEI, BUSEI, ABACE, AURIE, 6
AURII  -->  TAREI, CUBAM, DEGAJ, ABUZA, AURII, 5
AURIM  -->  TAREI, MUCII, AURIM, 3
AURIT  -->  TAREI, TACIT, MASAJ, ABUZA, AURIT, 5
AURIU  -->  TAREI, MUCII, AFISA, ABACA, ABATA, ABATI, ABATU, AURIU, 8
AUROS  -->  TAREI, CUMAS, ABACA, AUROS, 4
AURUL  -->  TAREI, CUMAS, DALAJ, ACHII, AURUL, 5
AUSEI  -->  TAREI, MALOS, CAPAN, ADAOG, AUSEI, 5
AUSEL  -->  TAREI, CALUS, ABACA, AUSEL, 4
AUTOR  -->  TAREI, CURAT, TORBA, AUTOR, 4
AUTUL  -->  TAREI, SOCUL, PATAM, BAHNA, GAFEZ, ALDAN, ALACE, ALAIT, ALAMA, ALAME, ALAMI, ALANA, ALANE, ALANI, ALAUN, ALBEA, ALBEI, ALBET, ALBIA, ALBIE, ALBII, ALBIM, ALBIT, ALBIU, ALBUI, ALBUL, ALBUM, ALBUS, ALBUT, ALCAN, ALCOV, ALDIN, ALDOL, ALDUI, ALEAN, ALEEA, ALEGA, ALEGE, ALEGI, ALEIA, ALEII, ALELA, ALELE, ALENA, ALENE, ALERG, ALERT, ALESE, ALESI, ALEZA, ALEZE, ALGEI, ALGIA, ALGID, ALGIE, ALGII, ALGOL, ALIAI, ALIAJ, ALIAM, ALIAS, ALIAT, ALIAU, ALIBI, ALICA, ALICE, ALICI, ALIEM, ALIEZ, ALINA, ALINE, ALINI, ALINT, ALIOR, ALIPI, ALMAR, ALMEE, ALMEI, ALOCA, ALOCE, ALOCI, ALOEA, ALOEI, ALORA, ALOUL, ALPIN, ALTAR, ALTEI, ALTER, ALTII, ALTOI, ALTOR, ALTUI, ALTUL, AUTUL, 95
AUZEA  -->  TAREI, CALUS, DUNGA, ABACA, AUZEA, 5
AUZII  -->  TAREI, SACAL, MANAU, PAUZA, AGAVA, AUZII, 6
AUZIM  -->  TAREI, SALCI, MANAU, MIMAI, MIMAM, IUBII, AUZIM, 7
AUZIT  -->  TAREI, SANTI, CAUTI, TUITI, TOITI, PLIAM, AGITI, ABDIC, AUZIT, 9
AUZUL  -->  TAREI, COLUN, GALES, ZAPAJ, HALIM, ADVON, AUZUL, 7
AVAET  -->  TAREI, SALCA, PATMA, BATOG, TATUA, TAFNA, AHTIA, ABACA, AVAET, 9
AVAMA  -->  TAREI, COLUN, SAPAM, MAZGA, ABJUR, AVAMA, 6
AVAME  -->  TAREI, SALCE, POUND, BAGAM, AVAME, 5
AVAMI  -->  TAREI, SACAL, MANAU, ZAMBO, GAVAJ, ABACA, AVAMI, 7
AVANA  -->  TAREI, COLUN, MANSA, VANDA, ABACA, AVANA, 6
AVAND  -->  TAREI, COLUN, MANSA, BANDA, AGAVA, AVAND, 6
AVANE  -->  TAREI, SALCE, POUND, AMHAR, ABACA, AVANE, 6
AVANI  -->  TAREI, SACAL, MANAU, PONIV, ALIAJ, AVANI, 6
AVANS  -->  TAREI, COLUN, MANSA, SPADA, ABACA, ABATA, ABAUA, ABCES, AVANS, 9
AVANT  -->  TAREI, SOCUL, TAMAN, TABAN, TANGA, TANAJ, HANAP, FAZAN, DIVAN, ABNEG, AVANT, 11
AVARA  -->  TAREI, MORUA, SCARP, AFIXE, ACTIV, AVARA, 6
AVARE  -->  TAREI, MARSE, BOARD, CRUPA, BRAVA, AVARE, 6
AVARI  -->  TAREI, CARUB, GAMAN, PROIS, VIRIL, BAGAJ, AIDAM, AVARI, 8
AVATI  -->  TAREI, CATAU, PANAS, BATAL, VATAM, OASTE, ABACA, AVATI, 8
AVEAI  -->  TAREI, MASLU, VADAN, AGENT, AVEAI, 5
AVEAM  -->  TAREI, SALCE, MUNDA, POEME, AVEAM, 5
AVEAU  -->  TAREI, SALCE, MUNDA, AGAVA, AVEAU, 5
AVELE  -->  TAREI, SALCE, PLUMB, GOANA, ELEVA, AVELE, 6
AVENA  -->  TAREI, SALCE, MUNDA, ZBENG, AVENA, 5
AVENE  -->  TAREI, SALCE, POUND, AMHAR, ABACA, ABACE, ABALE, ABATA, ABATE, ABATI, ABATU, ABAUA, ACAJU, ACANA, ACANI, ACANT, ACARE, ACARI, ACASA, ACATA, ACATE, ACATI, ACEEA, AVENE, 24
AVERE  -->  TAREI, MARSE, BOARD, PLACU, AGAVA, ABACA, ABACE, ABALE, ABATA, ABATE, ABATI, ABATU, ABAUA, ACAJU, ACANA, ACANI, ACANT, ACARE, ACARI, ACASA, ACATA, ACATE, ACATI, ACEEA, AVERE, 25
AVERI  -->  TAREI, ACREA, PEDES, FIREZ, GREAM, AVERI, 6
AVERS  -->  TAREI, MARSE, PERSA, SOREA, SAREA, SARLE, SERBA, CEREA, SARGE, SUREA, SARDE, SERVE, ABACA, AVERS, 14
AVETI  -->  TAREI, FATAL, BATEM, VATAS, ABACA, AVETI, 6
AVIAR  -->  TAREI, CURII, MORII, PARGI, BARNI, VADII, VIRAI, JARUL, ABATI, AVIAR, 10
AVIDA  -->  TAREI, SALCI, MANAU, ZODII, VIPII, ABTII, AVIDA, 7
AVIDE  -->  TAREI, MASLE, CAIND, GAFEZ, ACTIV, AVIDE, 6
AVION  -->  TAREI, SALCI, MANAU, PODII, NAIVA, ABACA, AVION, 7
AVIVA  -->  TAREI, SALCI, MANAU, ZODII, PAGAI, JABIA, AFANA, AVIVA, 8
AVIZA  -->  TAREI, SALCI, MANAU, ZODII, GAZAI, HAPAI, BAIAI, ABACA, AVIZA, 9
AVIZE  -->  TAREI, MASLE, CAIND, AXEZE, AVIZE, 5
AVIZI  -->  TAREI, SACAL, MANAU, ZAPAJ, VOZAI, ABACA, AVIZI, 7
AVIZO  -->  TAREI, SALCI, MANAU, ZODII, POZAI, ARZOI, AVIZO, 7
AVLIA  -->  TAREI, SALCI, MAFII, PUVOI, ABATI, ABACA, AVLIA, 7
AVLIE  -->  TAREI, MASLE, BAZIC, APLEC, AVLIE, 5
AVLII  -->  TAREI, SACAL, ALBUM, EVING, AVLII, 5
AVORT  -->  TAREI, CURAT, FORAS, LORAN, BATAV, AVORT, 6
AVRAM  -->  TAREI, CUMAS, HAVAM, ABACA, AVRAM, 5
AVURA  -->  TAREI, MORUA, BRUSC, GRUNZ, PAJUL, ACTIV, AVURA, 7
AVUSE  -->  TAREI, SALCE, SOUND, AMPER, AVUSE, 5
AVUSI  -->  TAREI, SACAL, SAPAU, SAMAN, ADAUG, ABUZA, AVUSI, 7
AVUTA  -->  TAREI, SOCUL, MANAT, BATAJ, PATUT, ZADUF, AGAUA, ABACA, ABACE, ABALE, ABATA, AVUTA, 12
AVUTE  -->  TAREI, SALTA, UBACE, ADORM, ABJUR, AVUTE, 6
AVUTI  -->  TAREI, CATAU, TUSUL, BUTAN, HAVAM, ABACA, AVUTI, 7
AXAND  -->  TAREI, COLUN, MANSA, BANDA, AGAVA, AXAND, 6
AXARA  -->  TAREI, MORUA, SCARP, AFIXE, AXARA, 5
AXARE  -->  TAREI, MARSE, BOARD, CRUPA, BRAVA, AFIXE, AXARE, 7
AXARI  -->  TAREI, CARUB, GAMAN, PROIS, VIRIL, ZADIA, JARII, ACRIA, AFIXE, AXARI, 10
AXASE  -->  TAREI, SALCE, SOUND, ASABI, AXASE, 5
AXASI  -->  TAREI, SACAL, SAPAU, SABIN, SFIAM, SASAI, VAIAG, SASAU, SAHAN, SOSIA, SARAD, ASSAI, AFIXE, AXASI, 14
AXATA  -->  TAREI, SOCUL, TAMAN, BATAV, PAFUG, AFIXE, AXATA, 7
AXATE  -->  TAREI, SALTA, UBACE, TOPIM, ATING, AFIXE, AXATE, 7
AXATI  -->  TAREI, CATAU, PANAS, BATAL, VATAM, TOIAG, TAXID, ABACA, AXATI, 9
AXELE  -->  TAREI, SALCE, PLUMB, GOANA, ELEVA, ALELA, AFIXE, AXELE, 8
AXEZE  -->  TAREI, SALCE, POUND, BAGAM, AXEZE, 5
AXEZI  -->  TAREI, MASLU, VADAN, GOPAC, BARIZ, ABDIC, ABTIE, ABTII, ABTIN, ABTIU, ABUZA, AXEZI, 12
AXIAL  -->  TAREI, SALCI, MULII, PANII, BOLII, VIGII, FILAI, HLIZI, AJUTI, ABATI, ABILI, ABOLI, ABTII, ABURI, ACANI, ACARI, ACATI, ACERI, ACHII, ACILI, ACIRI, ACIUI, ACIZI, ACREI, ACRII, ACRUL, AXIAL, 27
AXILA  -->  TAREI, SALCI, MULII, PANII, BOLII, VIGII, FILAI, ZIDII, ALIAI, AERAJ, ABACA, AXILA, 12
AXILE  -->  TAREI, MASLE, ABNEG, AXILE, 4
AXION  -->  TAREI, SALCI, MANAU, PODII, NAIVA, FIXAJ, AXION, 7
AXONI  -->  TAREI, SACAL, MANAU, PONIV, AFUND, AXONI, 6
AXURI  -->  TAREI, CARUB, UZUAL, AMHAR, AFIXE, AXURI, 6
AZERA  -->  TAREI, MARSE, CARDA, PEREN, GEREZ, AEROB, AZERA, 7
AZERE  -->  TAREI, MARSE, BOARD, PLACU, AGAVA, ANEXA, AZERE, 7
AZERI  -->  TAREI, ACREA, PEDES, FIREZ, AZERI, 5
AZIDA  -->  TAREI, SALCI, MANAU, ZODII, ABACA, AZIDA, 6
AZIDE  -->  TAREI, MASLE, CAIND, GAFEZ, AZIDE, 5
AZIMA  -->  TAREI, SALCI, MANAU, MIZAI, MAZGA, APOZI, AZIMA, 7
AZIME  -->  TAREI, MASLE, CAIND, ABACA, AZIME, 5
AZOIC  -->  TAREI, SALCI, CAUNI, CAPII, CADII, MAZGI, ABDIC, AZOIC, 8
AZTEC  -->  TAREI, SALCA, CADOU, BATCA, AEDUL, AZTEC, 6
AZURA  -->  TAREI, MORUA, BRUSC, GRUNZ, ABDIC, AZURA, 6
AZURI  -->  TAREI, CARUB, UZUAL, AZURI, 4
BABAC  -->  TAREI, SULAC, MIZID, ABACA, BABAC, 5
BABAN  -->  TAREI, SULAC, MEZIN, GHEBA, ABNEG, ACNEE, ADNAT, AGNAT, AGNET, ALBEA, BABAN, 11
BABAR  -->  TAREI, SCRUM, BORZA, JIDAN, BABAR, 5
BABAU  -->  TAREI, SULAC, PAVEZ, AFGAN, BABAU, 5
BABEI  -->  TAREI, VOLSC, MAIND, BOGZA, BABEI, 5
BABOI  -->  TAREI, SPLIN, MUZIC, GAVAJ, BAIND, ABILA, ABILE, ABILI, ABOLI, BABOI, 10
BACAI  -->  TAREI, SPLIN, MUZIC, BOVID, ABDIC, ABRAC, BACAI, 7
BACAL  -->  TAREI, SULAC, BOLIM, ABCES, BACAL, 5
BACAN  -->  TAREI, SULAC, MEZON, ABACA, BACAN, 5
BACAU  -->  TAREI, SULAC, BAZAM, BACAU, 4
BACEI  -->  TAREI, VOLSC, IMBUN, BACEI, 4
BACII  -->  TAREI, SPLIN, MUCED, BAGAJ, BACII, 5
BACIL  -->  TAREI, SUNCI, CLIPI, CALIM, BELGI, ABCES, BACIL, 7
BACIT  -->  TAREI, TUSII, LOTCI, TICNA, BUGED, BACIT, 6
BACON  -->  TAREI, SULAC, MOZAN, APROB, BACON, 5
BACUL  -->  TAREI, SULAC, CALUP, CHIBZ, ABCES, BACUL, 6
BADEA  -->  TAREI, MULSA, DECAN, GUBAV, BADEA, 5
BADEI  -->  TAREI, VOLSC, MAIND, BIFEZ, BADEI, 5
BADIA  -->  TAREI, SUNCI, MOLII, GAZDA, ABDIC, BADIA, 6
BADIC  -->  TAREI, SUNCI, CLIPI, MOCII, BUJDI, BADIC, 6
BADIE  -->  TAREI, SLICE, UNDIM, ABUZA, BADIE, 5
BADII  -->  TAREI, SPLIN, MUCED, BIFEZ, BADII, 5
BAFTA  -->  TAREI, TUCAL, SONAM, PAVAJ, BOGZA, BAFTA, 6
BAFTE  -->  TAREI, TUNEL, CAPES, GUMEZ, ABACA, ABACE, BAFTE, 7
BAGAI  -->  TAREI, SPLIN, MUZIC, GAVAJ, BAFTA, BAGAI, 6
BAGAJ  -->  TAREI, SULAC, MEZIN, GEPID, ABACA, BAGAJ, 6
BAGAM  -->  TAREI, SULAC, MEZIN, GEPID, ABACA, BAGAM, 6
BAGAT  -->  TAREI, TUCAL, SMINT, PITIG, BIFEZ, BAGAT, 6
BAGAU  -->  TAREI, SULAC, PAVEZ, AFGAN, BAGAU, 5
BAGEA  -->  TAREI, MULSA, DECAN, HAVEZ, BAGEA, 5
BAHIC  -->  TAREI, SUNCI, CLIPI, MOCII, BUJDI, ACCIZ, ABATI, ABCES, ABDIC, BAHIC, 10
BAHLA  -->  TAREI, SULAC, VOLAN, MOLDA, GHEBA, ABALE, BAHLA, 7
BAHLE  -->  TAREI, CULES, MOLDE, PUHAV, BAHLE, 5
BAHLI  -->  TAREI, SPLIN, CUBAM, BOLID, ACHII, BAHLI, 6
BAHNA  -->  TAREI, SULAC, MOZAN, BANDA, BAHNA, 5
BAHNE  -->  TAREI, CULES, PENEZ, JAMBA, ABNEG, ABONA, BAHNE, 7
BAHTI  -->  TAREI, TUCAN, TOPIM, TOBAS, AHTIA, BAHTI, 6
BAIAI  -->  TAREI, SPLIN, MUZIC, GAVAJ, ABACA, BAIAI, 6
BAIAM  -->  TAREI, SUNCI, MOLII, MEZII, MAFII, MAKII, GHIDI, ABACA, BAIAM, 9
BAIAN  -->  TAREI, SUNCI, DOMNI, VIPII, BANII, ABILA, BAIAN, 7
BAIAS  -->  TAREI, SUNCI, SPLAI, SVABA, ABATI, ABCES, BAIAS, 7
BAIAT  -->  TAREI, TUSII, CLINI, BAHTI, ABATA, ABATI, ACATA, ACATI, ACUTA, ACUTI, ADIAI, BAIAT, 12
BAIAU  -->  TAREI, SUNCI, GHILI, ABOLI, BAIAU, 5
BAIER  -->  TAREI, ROIND, APUCI, ABATI, BAIER, 5
BAIES  -->  TAREI, VOLSC, PUMNI, DAFII, ABACA, BAIES, 6
BAIET  -->  TAREI, BLIMP, BAIET, 3
BAILE  -->  TAREI, SLICE, ABNEG, BAILE, 4
BAIND  -->  TAREI, SUNCI, DOMNI, BAHLA, BAIND, 5
BAIRA  -->  TAREI, SCRIM, BURII, FAZII, INRAI, ALIAI, ABACA, BAIRA, 8
BAIRE  -->  TAREI, ROIBE, BAIRE, 3
BAIRI  -->  TAREI, SCRIM, RUBIN, FIRIZ, APRIL, ACRIA, ACRIE, ACRII, ACRIM, ACRIS, ACRIT, ACRIU, AGRIS, APRIG, ATRII, ATRIU, AURIA, AURIE, AURII, AURIM, AURIT, AURIU, BAIAI, BAIRI, 24
BAISE  -->  TAREI, SLICE, BLIMP, BAISE, 4
BAISI  -->  TAREI, SPLIN, SUCIM, DESAG, BUHAV, ABDIC, ABILA, BAISI, 8
BAITA  -->  TAREI, TUSII, CLINI, BAHTI, ABACA, BAITA, 6
BAITE  -->  TAREI, CLIPE, ABNEG, BAITE, 4
BAITI  -->  TAREI, TUCAN, TOPIM, TOBAS, AHTIA, ALTII, ABTIE, ABTII, ABTIN, ABTIU, ACTIV, AHTIE, ANTIC, APTII, ASTIA, BAIAI, BAITI, 17
BAIUL  -->  TAREI, SUNCI, GHILI, BIFAM, BAIUL, 5
BALAC  -->  TAREI, SULAC, ABDIC, BALAC, 4
BALAI  -->  TAREI, SPLIN, COBIM, BADIA, ABDIC, ABRAC, BALAI, 7
BALAN  -->  TAREI, SULAC, HOJMA, ABACA, BALAN, 5
BALAS  -->  TAREI, SULAC, ABCES, BALAS, 4
BALCI  -->  TAREI, SPLIN, COBIM, BALCI, 4
BALEI  -->  TAREI, VOLSC, GHIZD, ABJUR, BALEI, 5
BALET  -->  TAREI, BULCA, BALET, 3
BALIA  -->  TAREI, SUNCI, MOLII, DEPUI, GHEBA, BALIA, 6
BALIC  -->  TAREI, SUNCI, CLIPI, CALIM, BAGAI, BALIC, 6
BALIE  -->  TAREI, SLICE, BAIND, ABALE, ABDIC, BALIE, 6
BALII  -->  TAREI, SPLIN, ABDIC, BALII, 4
BALON  -->  TAREI, SULAC, HOBAN, BALON, 4
BALOS  -->  TAREI, SULAC, SOFAM, ABNEG, BALOS, 5
BALOT  -->  TAREI, TUCAL, SOLBA, BALOT, 4
BALSA  -->  TAREI, SULAC, SOFAM, BRAVA, BALSA, 5
BALSE  -->  TAREI, CULES, SVABE, ACASA, BALSE, 5
BALTA  -->  TAREI, TUCAL, SOLBA, BALTA, 4
BALTI  -->  TAREI, TUCAN, TOPIM, TOBAS, AHTIA, ALTII, BALTI, 7
BALUL  -->  TAREI, SULAC, VAGUL, BLIMP, BALUL, 5
BALUT  -->  TAREI, TUCAL, TALUS, BAZAL, BALUT, 5
BAMEI  -->  TAREI, VOLSC, MAIND, GHIOB, BAMEI, 5
BANAL  -->  TAREI, SULAC, NAMOL, BENZI, BANAL, 5
BANAN  -->  TAREI, SULAC, MEZIN, GHEBA, ABNEG, BANAN, 6
BANAT  -->  TAREI, TUCAL, SMINT, BENZI, BANAT, 5
BANCA  -->  TAREI, SULAC, MOZAN, BANDA, BANCA, 5
BANCI  -->  TAREI, SPLIN, UGNIM, VEDIC, ABACA, BANCI, 6
BANCO  -->  TAREI, SULAC, MOZAN, APROB, ABACA, BANCO, 6
BANDA  -->  TAREI, SULAC, MOZAN, BANDA, 4
BANDE  -->  TAREI, CULES, PENEZ, BADEA, BANDE, 5
BANEA  -->  TAREI, MULSA, DECAN, ABJUR, BANEA, 5
BANEI  -->  TAREI, VOLSC, MAIND, BENZI, BANEI, 5
BANET  -->  TAREI, BULCA, AMANA, BANET, 4
BANIA  -->  TAREI, SUNCI, DUBIM, ABACA, BANIA, 5
BANIE  -->  TAREI, SLICE, UNDIM, BANIE, 4
BANII  -->  TARE